#|NBR|
%|PCT|
10k VALUE|10K|
12 DIGIT CODE ON INCOMING CLAIMS|PAMC|
25% CONCENTRATION|25CON|
4 NUMBER ZIP CODE|ZIP4|
5 NUMBER ZIP CODE|ZIP5|
52 WEEKS|52WK|
ABANDON|ABNDN|
ABANDONED|ABNDN|
ABBREVIATED|ABBR|
ABBREVIATED NEW DRUG APPLICATION|ANDA|
ABBREVIATION|ABBR|
ABORTION|ABTN|
ABSENCE|ABSN|
ACCEPT|ACPT|
ACCEPTED|ACPT|
ACCEPTOR|ACPT|
ACCESS|ACCS|
ACCIDENT|ACC|
ACCIDENTAL|ACC|
ACCIDENTAL DEATH AND DISMEMBERMENT|ADAD|
ACCOMMODATION|ACOM|
ACCOMPLISHMENT|ACMP|
ACCORDANT|ACRD|
ACCOUNT|ACCT|
ACCOUNT RECEIVABLES|AR|
ACCOUNTABILITY|ACCTB|
ACCOUNTED|ACCT|
ACCOUNTING|ACCT|
ACCREDITATION|ACD|
ACCRUE|ACRU|
ACCRUED|ACRU|
ACCUMULATED|ACCUM|
ACCUMULATION|ACCUM|
ACCUMULATIONS|ACCUM|
ACCUMULATIVE|ACCUM|
ACCURATE|ACCR|
ACKNOWLEDGE|ACK|
ACKNOWLEDGED|ACK|
ACKNOWLEDGEMENT|ACK|
ACQUISITION|ACQ|
ACRONYM|ACRYN|
ACTION|ACTN|
ACTIVATION|ACTV|
ACTIVATIONS|ACTV|
ACTIVE|ACTV|
ACTIVITY|ACTV|
ACTUAL|ACTL|
ACTUAL ACQUISITION COST|AAC|
ACTUARIAL|ACT|
ACUPUNCTURE|ACUPT|
ADAMANTINOMAS|ADMTNM|
ADDITIONAL|ADDL|
ADDRESS|ADDR|
ADJUDICATED|ADJUD|
ADJUDICATION|ADJUD|
ADJUST|ADJ|
ADJUSTED|ADJ|
ADJUSTED WALGREENS PRICE|AWP|
ADJUSTMENT|ADJ|
ADMINISTERED|ADMN|
ADMINISTRATING|ADMN|
ADMINISTRATION|ADMN|
ADMINISTRATIVE|ADMN|
ADMINISTRATOR|ADMN|
ADMISSION|ADM|
ADMIT|ADM|
ADMITTING|ADM|
ADOPTION|ADPT|
ADVANTAGE|ADV|
ADVANTAGE 90|ADV90|
ADVERSE INTERACTION|ADI|
ADVERTISE / ADVERTISING|AD|
AFFECT|AFFT|
AFFECTED|AFFT|
AFFECTS|AFECT|
AFFILIATION|AFFL|
AFFLIATE|AFLT|
AGAINST|AGNST|
AGENCY|AGCY|
AGENT|AGT|
AGGREGATE|AGGR|
AGREEMENT|AGRE|
ALCOHOL|ALCH|
ALIASING|ALIAS|
ALL|ALL|
ALL EXCEPT|ALX|
ALLERGEN CODE|AC|
ALLERGEN PATTERN CODE|APC|
ALLERGY|ALGY|
ALLIANCE|ALNC|
ALLOCATED|ALLOC|
ALLOCATION|ALLOC|
ALLOW|ALW|
ALLOWANCE|ALW|
ALLOWED|ALW|
ALOPECIA AREATA|ALPART|
ALTERNATE|ALT|
ALTERNATIVE|ALT|
ALTFUND|AF|
ALVEOLAR|ALVLR|
AMBULANCE|AMB|
AMBULATORY|AMBTY|
AMENDMENT|AMND|
AMERICAN|AMER|
AMERICAN HOSPITAL FORMULARY SERVICE|AHFS|
AMERICAN HOSPITAL FORMULARY SERVICE CLASSIFICATION COMPILATION|AHFSCC|
AMERICAN MANAGED CARE AND REVIEW ASSOCIATION|AMCRA|
AMERICAN MEDICAL ASSOCIATION|AMA|
AMERICAN SOCIE TY OF HEALTH SYSTEM PHARMACISTS|ASHP|
AMERICAN SOCIETY FOR AUTOMATION IN PHARMACY|ASAP|
AMERICAN SOCIETY OF CONSULTANT PHARMACISTS|ASCP|
AMOUNT|AMT|
ANALYST|ANLS|
ANATOMICAL|ANAT|
ANCILLARY|ANCL|
ANESTHESIA|ANES|
ANIMAL|ANML|
ANNUAL|ANNL|
ANNUITY|ANUTY|
ANNULMENT|ANUL|
ANSWER|ANS|
ANTICIPATED|ANTCP|
APARTMENT|APT|
APPEAL|APEL|
APPLIANCE|APLNC|
APPLICABLE|APBL|
APPLICANT|APLCNT|
APPLICATION|APP|
APPLIED|APP|
APPLY|APP|
APPROPRIATE|APRP|
APPROPRIATENESS|APRP|
APPROVAL|APPRVL|
APPROVE|APRV|
APPROVED|APPRV|
APPROVER|APRV|
ARCHIVE|ARCH|
ARITHMETIC|ARITH|
ARRANGEMENT|ARNG|
ARREARS|ARRS|
ARTERIAL|ARTRL|
ARTIFICIAL|ARTFL|
AS SOON AS POSSIBLE|ASAP|
ASSESSMENT|ASSMT|
ASSIGN|AASGN|
ASSIGNED|ASSGN|
ASSIGNMENT|ASGN|
ASSISTANCE|ASST|
ASSISTANT|ASST|
ASSISTED REPRODUCTIVE TECHNOLOGY|ART|
ASSOCIATE|ASSOC|
ASSOCIATED|ASSOC|
ASSOCIATION|ASSOC|
ASSORT|ASSRT|
ASSUMED|ASM|
ASSUMPTIONS|ASM|
ATTACH|ATCH|
ATTACHMENT|ATCH|
ATTEMPT|ATMPT|
ATTEND|ATND|
ATTENDING|ATND|
ATTENTION|ATTN|
ATTORNEY|ATTY|
ATTRIBUTE|ATTR|
AUDIT|AUD|
AUDITOR|AUDR|
AUTHENTICATOR|AUTH|
AUTHORIZATION|AUTH|
AUTHORIZE|AUTH|
AUTHORIZED|AUTH|
AUTOMATED CLEARING HOUSE|ACH|
AUTOMATIC|AUTO|
AUTOPSY|ATPSY|
AVAILABLE|AVBL|
AVERAGE|AVG|
AVERAGE AVERAGE WHOLESALE PRICE|AAWP|
AVERAGE RETAIL PRICE|ARP|
AVERAGE WHOLESALE PRICE|AWP|
AVOIDANCE|AVDNC|
AWARE|AWAR|
AWARE INTEGRATED INC|AII|
AWARE INTEGRATED INCORPORATED|AII|
BACKUP|BKUP|
BALANCE|BAL|
BAND|BAND|
BARGAIN|BRGN|
BARGAINING|BRGN|
BARIATRIC|BARI|
BASE LINE PRICE|BLP|
BASELINE|BASL|
BASIC|BSIC|
BASIC DEPARTMENT MANAGEMENT|BDM|
BASIS|BSIS|
BASKET|BSKT|
BATCH|BTCH|
BATTERY|BATRY|
BEAUTY ADVISOR|BA|
BEFORE|BEFR|
BEGIN|BEG|
BEHAVIOR HEALTH CASES|BHC|
BENEFICIARY|BENF|
BENEFIT|BEN|
BENEFIT SERVICE LEVEL|BSL|
BERGEN PHARMACY VENDOR|BERGEN|
BEST|BEST|
BEVERAGE|BEV|
BIFOCAL|BIFL|
BILLED|BILL|
BILLER|BILL|
BILLING|BILL|
BIRTH|BRTH|
BLIND COPY E-MAIL|BCC|
BLOCK|BLCK|
BLOCKED|BLCK|
BLOOD|BLD|
BLUE CARD|BCRD|
BLUE CHOICE|BLCH|
BLUE CROSS|BC|
BLUE CROSS BLUE SHIELD|BCBS|
BLUE CROSS BLUE SHIELD OF MINNESOTA|BCBSM|
BLUE PLUS|BP|
BLUE SHIELD|BS|
BOARD|BD|
BONE MARROW|BM|
BOOK OF BUSINESS|BOB|
BOTTOM|BTTM|
BOUND|BND|
BRACKET|BRKT|
BRANCH|BRNCH|
BRAND|BRAND|
BRANDED|BRND|
BRANDING|BRND|
BREAK|BRK|
BREAKDOWN|BKDN|
BREAST|BRST|
BRITISH APPROVED NAME|BAN|
BROKER|BRKR|
BROKERAGE|BRKRG|
BUDGET|BDGT|
BUILDING|BLDNG|
BULK|BLK|
BULLETIN|BLTN|
BUNDLED|BNDL|
BUREAU|BURV|
BURSTED|BURT|
BUSINESS|BUSS|
BUSSINESS|BUSS|
BUY A GET B FREE|BAGB|
BUY ONE GET ONE FREE|BOGO|
BUYER|BYR|
BYPASS|BYP|
CALCULATE|CALC|
CALCULATED|CALC|
CALCULATION|CALC|
CALENDAR|CAL|
CALL|CALL|
CALLBACK|CB|
CANCEL|CNL|
CANCER|CNCR|
CAPABLE|CAPBL|
CAPITAL|CPTL|
CAPITATED|CAP|
CAPITATION|CAP|
CAPTION|CPTN|
CARBON COPY E-MAIL|CC|
CARD EXTRACT FILE|CEF|
CARD HOLDER|CDHLDR|
CARDHOLDER|CDHLDR|
CARDIAC|CRDC|
CARDINAL HEALTH PHARMACY VENDOR|CARDINAL|
CARDIOVASCULAR|CRDVSL|
CARRIER|CARR|
CARRY|CARY|
CARRYOVER|CRYVR|
CARTRIDGE|CRTDG|
CARVE OUT|CRVO|
CASH ON DELIVERY|COD|
CASHIER|CASHIER|
CASUALTY|CSLTY|
CATASTROPHIC|CTSTRP|
CATEGORY|CAT|
CATEGORY MANAGER|CM|
CEILING|CEIL|
CENSUS|CENSUS|
CENTER|CNTR|
CENTRAL|CNTRL|
CENTURY|CENTRY|
CERTIFIABILITY|CERT|
CERTIFICATE|CERT|
CERTIFICATION|CERTF|
CESSATION|CSSTN|
CHAIN|CHN|
CHANGE|CHNG|
CHANGE OF ADDRESS|COA|
CHANNEL|CHNL|
CHARGE|CHG|
CHECK|CHK|
CHECKER|CHKR|
CHEMICAL|CHEM|
CHEMICAL ABSTRACTS SERVICE|CAS|
CHEMICAL DEPENDENCY|CD|
CHEMOTHERAPY|CHEMO|
CHILD|CHD|
CHILDREN|CHD|
CHIROPRACTIC|CHIRO|
CHOICE|CHC|
CHRISTIAN|CHRSTN|
CHRONIC|CHR|
CIGARETTE|CIG|
CITIZENSHIP|CITZN|
CITY|CITY|
CLAIM|CLAIM|
CLAIMABLE|CLAIM|
CLARIFICATION|CLFCTN|
CLASS|CLASS|
CLASSIFIC|CLASS|
CLASSIFICATION|CLASS|
CLASSIFIER|CLASS|
CLEAN|CLEAN|
CLEAN, NEAT AND ORDERLY|CNO|
CLEARANCE|CLRNC|
CLEARINGHOUSE|CLRHS|
CLEFT|CLFT|
CLERGY|CLGY|
CLERK|CLK|
CLIENT|CLIENT|
CLIENT PRIOR AUTHORIZATIONS|CPA|
CLINIC|CLINIC|
CLINICAL|CLIN|
CLOSE|CLS|
CLOSE OF BUSINESS|COB|
CLOSED|CLSD|
CLUSTER|CLR|
COBRA|CBRA|
COCHLEAR|CHLR|
CODE|CD|
CODING|CD|
COINSURANCE|COINS|
COLOR|COLR|
COLUMN|COL|
COMBINATION|CMBN|
COMBINE|COMBIN|
COMBINED|COMB|
COMFORT|CMFT|
COMMAND|CMD|
COMMENT|CMNT|
COMMERCE|COMM|
COMMERCIAL|COMC|
COMMISSION|CMSN|
COMMIT|CMMT|
COMMITTEE|CMTE|
COMMON|CMN|
COMMON PROCEDURAL TERMINOLOGY VERSION 4|CPT4|
COMMUNICATION|COMM|
COMPANY|CO|
COMPARABLE|COMPRBL|
COMPARE|COMPR|
COMPARISON|CMPSN|
COMPENSATION|COMP|
COMPETITOR|CMPTR|
COMPLAIN|CMPLN|
COMPLAINT|CMPLN|
COMPLEMENT|COMP|
COMPLETE|COMP|
COMPLETING|COMP|
COMPLETION|COMP|
COMPLIANCE|CMPLIA|
COMPLICATION|CMPLC|
COMPONENT|CPNT|
COMPOSER|CMPR|
COMPOSITE|CMPO|
COMPOUND|CMPD|
COMPOUNDABLE|CMPDBL|
COMPREHENSIVE|CMPRH|
COMPREHENSIVE MAJOR MEDICAL|CMM|
COMPREHENSIVE MANAGED CARE|CMC|
COMPRESSION|CMPRN|
COMPULSIVE|CMPL|
CONCEPT|CNCPT|
CONCURRENT|CONC|
CONDITION|COND|
CONDUCTED|CNDT|
CONFIDENTIALITY|CNFDT|
CONFIGURATION|CFG|
CONFINEMENT|CNFT|
CONFIRMED|CNFM|
CONFORMED|CONFD|
CONNECTION|CNNCT|
CONSENT|CNST|
CONSEQUENT|CNSQ|
CONSIDERATION|CNSD|
CONSOLIDATE|CONSLDT|
CONSOLIDATED|CNSD|
CONSOLIDATED FRONT END|CFE|
CONSOLIDATION|CNSLN|
CONSORTIUM|CSRTM|
CONSTANT|CONST|
CONSULT|CNSL|
CONSULTANT|CNSL|
CONSULTATION|CNSL|
CONSULTED|CNSL|
CONSUMER|CONSM|
CONSUMER DIRECTED HEALTH PLAN|CDHP|
CONSUMER DRIVEN HEALTHCARE|CDH|
CONSUMER PRODUCT SAFETY COMMISSION|CPSC|
CONTACT|CNTC|
CONTACTED|CNTC|
CONTACTING|CNTC|
CONTAINED|CONTNR|
CONTAINER|CONTNR|
CONTAINMENT|CNMT|
CONTENT|CONTNT|
CONTESTED|CNTST|
CONTINGENCY|CNTNG|
CONTINUATION|CONT|
CONTINUOUS|CONT|
CONTRACEPTIVES|CNTRA|
CONTRACT|CNTRC|
CONTRACTING|CNTRC|
CONTRAINDICATION|CNTRIDCTN|
CONTRIBUTE|CNTB|
CONTRIBUTION|CNTB|
CONTROL|CNTL|
CONTROLLED SUBSTANCE INVENTORY|CSI|
CONVENIENT|CONV|
CONVERSION|CONV|
CONVERTED|CONV|
COOPERATIVE|COOP|
COORDINATE|COORD|
COORDINATION OF BENEFIT|COB|
COORDINATION OF BENEFITS|COB|
COORDINATOR|COORD|
COPAYMENT|COPAY|
CORNEA|CRN|
CORONARY CARE ANCILLARY|CCA|
CORP|CORP|
CORPORATE|CORP|
CORPORATION|CORP|
CORRECTION|COR|
CORRESPONDENCE|CORR|
COSMETIC|CSMTC|
COST|COST|
COST CEILING MAX|CCM|
COST CONTAINMENT|CC|
COST LEVEL|CL|
COUNSEL|CNSL|
COUNSELING|CNSL|
COUNT|CNT|
COUNTRY|CNTRY|
COUNTY|CNTY|
COUPON|COUP|
COURSE|CRSE|
COURT|CRT|
COVER|COV|
COVERAGE|COV|
COVERED|COV|
CRDHLDR|CDHLDR|
CREATE|CREATE|
CREATION|CREA|
CREDENTIAL|CRDTL|
CREDENTIALING|CRDTL|
CREDIT|CR|
CRITERIA|CRIT|
CROSS REFERENCE|XREF|
CROSSOVER|XOVR|
CROSS-SENSITIVITY CODE|CSC|
CUMULATIVE|CMLTV|
CURRENCY|CURCY|
CURRENT|CURR|
CURRICULUM|CURIC|
CURVE|CURV|
CUSTODY|CSTDY|
CUSTOM|CSTM|
CUSTOMER|CUST|
CUSTOMER INFORMATION SYSTEM|CIS|
CYCLE|CYC|
CYSTS|CYSTS|
DAMAGE|DMG|
DANGEROUS|DNGRS|
DATA|DATA|
DATA BASE|DB|
DATA GROUP|DG|
DATABASE|DB|
DATE|DT|
DATE AND TIME|DTTM|
DATE OF BIRTH|DOB|
DATE OF DEATH|DOD|
DATE OF ENROLLMENT|DOE|
DATE OF ENTRY IN MILITARY|DOMI|
DATE OF INJURY|DOI|
DATE OF LEGAL CUSTODY|DOLC|
DATE OF SERVICE|DOS|
DATETIME|DTTM|
DATE-TIMESTAMP|DTTM|
DAY|DAY|
DAYLIGHT|DAYLT|
DAYS|DAY|
DAYS OF SUPPLY|DOS|
DEAD ON ARRIVAL|DOA|
DEATH|DTH|
DEBIT|DR|
DECEASED|DEAD|
DECISION|DCSN|
DECISION SUPPORT SYSTEM|DSS|
DEDUCT|DED|
DEDUCTIBLE|DED|
DEFAULT|DFLT|
DEFERRAL|DEFR|
DEFERRED|DEFR|
DEFICIT|DEFI|
DEFINITION|DEF|
DEGREE|DEG|
DELAY|DLY|
DELETE|DEL|
DELETED|DEL|
DELINQUENT|DELQ|
DELIVERY|DLVRY|
DEMOGRAPHIC|DEMGR|
DEMOGRAPHICS|DEMGRS|
DEMONSTRATION|DEMO|
DENIAL|DN|
DENIED|DN|
DENTAL|DNT|
DENTIGEROUS|DNTG|
DEPARTMENT|DEPT|
DEPARTMENT OF HEALTH AND HUMAN SERVICES|HHS|
DEPARTMENTAL|DEPTT|
DEPENDENCY|DEP|
DEPENDENT|DEP|
DEPOSIT|DPST|
DEPOSITED|DEPOSTD|
DEPTH|DEPTH|
DERIVE|DERV|
DESCRIPTION|DESC|
DESCRIPTOR|DSPTR|
DESIGN|DSGN|
DESIGNATE|DSGN|
DESIGNATION|DSGN|
DESTINATION|DEST|
DETAIL|DTL|
DETERMINATION|DTR|
DEVELOPMENT|DVLPT|
DEVIATION|DEVN|
DEVICE|DEVC|
DIABETIC|DIAB|
DIAGNOSIS|DX|
DIAGNOSIS RELATED GROUPING|DRG|
DIAGNOSTIC|DIAG|
DIAGNOSTIC TESTING|DXT|
DIAGNOSTIC XRAY AND LABORATORY|DXL|
DIALER|DLR|
DIALYSIS|DLYS|
DICTATED|DCT|
DIFFERENCE|DIFF|
DIFFERENTIAL|DFFTL|
DIGIT|DGT|
DIMENSION|DIM|
DIRECT MEMBER REIMBURSEMENT|DMR|
DIRECT PRICE|DP|
DIRECTION|DIR|
DIRECTOR|DIR|
DIRECTORY|DIR|
DIRTY|DIRTY|
DISABILITY|DSAB|
DISABLE|DSAB|
DISABLED|DSAB|
DISBAND|DSBN|
DISBANDED|DSBN|
DISBURSE|DSB|
DISBURSEMENT|DISB|
DISCHARE|DISC|
DISCHARGE|DC|
DISCIPLINARY|DSPL|
DISCIPLINE|DSPL|
DISCLAIM|DSCLM|
DISCLAIMER|DSCLMR|
DISCLOSED|DSCLSD|
DISCLOSURE|DSCL|
DISCONTINUE|DISCNTN|
DISCOUNT|DISC|
DISCUSSION|DISC|
DISEASE|DISE|
DISEASE MANAGEMENT|DM|
DISKETTE|DISK|
DISMEMBER|DISM|
DISPENSE|DISP|
DISPENSE AS WRITTEN|DAW|
DISPENSED|DSPN|
DISPENSER|DISPR|
DISPLAY|DSPLY|
DISPLAYED|DSPLY|
DISPLAYER|DSPLYR|
DISPOSAL|DSPSAL|
DISPOSITION|DISP|
DISPROPORTIONATE|DPRPT|
DISTANCE|DSTN|
DISTINCT|DSTCT|
DISTRIBUTED|DISTR|
DISTRIBUTION|DISTR|
DISTRIBUTION CENTER|DC|
DISTRICT|DIST|
DISTRICT MANAGER|DM|
DISTRICT OFFICE|DO|
DISTRICT PHARMACY TRAINING COORDINATOR|DPTC|
DIVISION|DIV|
DIVISIONAL MERCHANDISE MANAGER|DMM|
DIVORCE|DVRC|
DOCUMENT|DOC|
DOCUMENTATION|DOC|
DOCUMENTED|DOC|
DOLLAR|DLRS|
DOLLARS|DLRS|
DOMAIN|DMN|
DOMESTIC|DMSTC|
DOMESTIC PARTNER|DMPART|
DONOR|DONR|
DOSAGE|DOSAG|
DOSES|DOSE|
DOWN|DWN|
DRAINAGE|DRNG|
DRAWN|DRN|
DRIVE|DRV|
DRIVER'S LICENSE|DL|
DRUG|DRG|
DRUG EFFICACY STUDY IMPLEMENTATION|DESI|
DRUG ENFORCEMENT ADMINISTRATION|DEA|
DRUG ENFORCEMENT AGENCY|DEA|
DRUG EVALUATIONS|DE|
DRUG IDENTIFICATION NUMBER|DIN|
DRUG THERAPY MONITORING SYSTEMTM|DTMS|
DRUG THERAPY SCREENING SYSTEM|DTSS|
DRUG UTILIZATION EVALUATION|DUE|
DRUG UTILIZATION REVIEW|DUR|
DRUG-DRUG INTERACTION|DDI|
DUN AND BRADSTREET|DBST|
DUPLICATE|DUPL|
DURABLE MEDICAL EQUIPMENT|DME|
DURATION|DUR|
DWELLING|DWELNG|
DYNAMIC|DYNM|
DYSFUNCTION|DYSF|
EARLY|ERLY|
EARNED|ERN|
ECOMMERCE|ECOMM|
EDIT|EDT|
EDITION|EDTN|
EDUCATION|EDU|
EFFECT|EFF|
EFFECTIVE|EFF|
EIGHT-UPS|8-UPS|
ELAPSED|ELPSD|
ELECTIVE|ELECT|
ELECTRONIC|ELEC|
ELECTRONIC DATA PROCESSING|EDP|
ELECTRONIC FUND TRANSFER|EFT|
ELEMENT|ELE|
ELIGIBILITY|ELIG|
ELIGIBLE|ELIG|
ELIMINATION|ELIM|
EMAIL|EML|
EMERGENCY|EMER|
EMERGENCY ROOM|ER|
EMPLOYED|EMP|
EMPLOYEE|EMP|
EMPLOYEE ASSISTANCE PROGRAMS|EAP|
EMPLOYER|EMPR|
EMPLOYER IDENTIFICATION NUMBER|EIN|
EMPLOYER PROVIDER NETWORK INCORPORATED|EPNI|
EMPLOYMENT|EMP|
ENABLE|ENA|
ENABLED|ENA|
ENCLOSURE|ENCL|
ENCOUNTER|ECNTR|
ENCRYPTED|ECRP|
ENCRYPTION|ECRP|
END|END|
ENDING|END|
ENDOCRINE|ENDCRN|
ENDORSEMENT|EDMT|
ENFORCE|ENFRC|
ENFORCEMENT|ENFRC|
ENGLISH|ENGL|
ENROLL|ENRL|
ENROLLMENT|ENRL|
ENTER|ENT|
ENTERED|ENT|
ENTERER|ENT|
ENTERPRISE|ENTPS|
ENTITY|ENTY|
ENVELOPE|ENV|
ENVIRONMENT|ENVRT|
EPISODE|EPIS|
EQUALITY|EQLTY|
EQUIPMENT|EQP|
EQUIVALENCY|EQU|
ERRONEOUS|ERR|
ERROR|ERR|
ERROR MESSAGE|ERRMSG|
ESCALATION|ESCLTN|
ESTABLISH|ESTB|
ESTABLISHED|ESTAB|
ESTIMATE|EST|
ESTIMATED|EST|
ETHNICITY|ETHN|
EUROPEAN ARTICLE NUMBER|EAN|
EVALUATION|EVAL|
EVENT|EVT|
EVERYDAY|EVRYDAY|
EXAMINATION|EXAM|
EXAMINER|EXAM|
EXCEED|EXCD|
EXCEEDING|EXCD|
EXCEPTION|EXCPN|
EXCEPTIONS|EXCPN|
EXCERPT|EXRP|
EXCESS|EXCS|
EXCHANGE|EXCHG|
EXCISE|EXCISE|
EXCISION|EXCSN|
EXCLUDE|EXCL|
EXCLUDED|EXCL|
EXCLUSION|EXCL|
EXCLUSIVE|EXCL|
EXCRETION|EXCRTN|
EXECPTION|EXCPT|
EXECUTE|EXC|
EXECUTED|EXC|
EXECUTIVE|EXEC|
EXEMPT|EXMPT|
EXEMPTION|XEMPT|
EXHAUST|EXH|
EXIT|EXIT|
EXPECT|EXPCT|
EXPECTATION|EXPCT|
EXPECTED|EXPCT|
EXPEDITE|EXPD|
EXPENSE|EXPN|
EXPIRATION|EXPIR|
EXPIRE|EXPIRE|
EXPLANATION|EXPLN|
EXPLANATION OF BENEFITS|EOB|
EXPLANATION OF MEDICARE BENEFITS|EOMB|
EXTENDED|EXTD|
EXTENSION|EXTN|
EXTENTION|EXT|
EXTERNAL|EXTR|
EXTRACT|EXTR|
EYEWEAR|EYEW|
FACILITATE|FAC|
FACILITATION|FCLTN|
FACILITY|FAC|
FACSIMILE|FAX|
FACT|FCT|
FACTOR|FCT|
FAMILY|FAM|
FEBRUARY|FEB|
FEDERAL|FED|
FEDERAL EMPLOYEE PROGRAM|FEP|
FEDERAL FINANCIAL PARTICIPATION|FFP|
FEE FOR SERVICE|FFS|
FEET|FT|
FELONY|FLNY|
FEMALE|FEM|
FIELD|FLD|
FIFTH|5TH|
FILE|FILE|
FILE TRACKING NUMBER|FTN|
FILING|FLNG|
FILL|FILL|
FILTER|FLTR|
FINAL|FNL|
FINANCIAL|FIN|
FINANCING|FIN|
FINDINGS|FINDG|
FINISH|FNSH|
FIRST|FIRST|
FIRST DATA BANK|FDB|
FIRST OF THE MONTH|FOM|
FISCAL|FISCAL|
FISCAL YEAR|FY|
FISICAL|FISC|
FIXED|FIX|
FLAG|FLAG|
FLAVOR|FLAV|
FLEXIBLE|FLXBL|
FLEXIBLE SPENDING ACCOUNT|FSA|
FLOATER|FLT|
FOLDER|FLDR|
FOLLOW UP|FU|
FOOD|FOOD|
FOOD AND DRUG ADMINISTRATION|FDA|
FOOD DRUG AGENCY|FDA|
FOOT|FOOT|
FORECAST|FCST|
FORECASTED|FRCST|
FOREIGN|FRGN|
FORFEITURE|FORF|
FORM|FRM|
FORMAT|FMT|
FORMULA|FRML|
FORMULARY|FORM|
FORWARD|FWD|
FOSTER|FSTR|
FOUNDATION|FNDN|
FOURTH|4TH|
FRAGILE|FRAGL|
FREQUENCY|FREQ|
FRESHNESS|FRSHNES|
FRIDAY|FRI|
FUDICIARY|FUDCRY|
FULL|FULL|
FULLTIME|FT|
FULLY INSURED|FI|
FUNCTION|FUNC|
FUNCTIONAL|FUNC|
FUNDAMENTAL|FNTL|
FUNDING|FUND|
FUNDING - BEN ENG|FND|
FURNISHED|FRNSH|
FUTURE|FUT|
GAMBLING|GMBLNG|
GENDER|GNDR|
GENERAL|GNRL|
GENERAL LEDGER|GL|
GENERAL MANAGER|GM|
GENERAL MERCHANDISE MANAGER|GMM|
GENERATED|GENR|
GENERIC|GEN|
GENERIC CODE NUMBER|GCN|
GENERIC EQUIVALENT AVERAGE PRICE|GEAP|
GENERIC FORMULATION SPECIFIC TO INGREDIENTS, ADMINISTRATION AND STRENGTH|GCNSEQNO|
GENERIC IDENTIFIER|GID|
GENERIC PRODUCT IDENTIFIER|GPI|
GENERIC PRODUCT PACKAGING CODE|GPPC|
GENERIC UTILIZATION|GU|
GEOGRAPHY|GEOG|
GERIATRIC|GRTRC|
GLOBAL|GBL|
GLOSSARY|GLSRY|
GOLDNET|GN|
GOVERNMENT|GOVT|
GRACE|GRC|
GRADE|GRD|
GRADUATION|GRAD|
GRAMS|GMS|
GRANDCHILD|GCHD|
GRANDCHILDREN|GCHD|
GRAPHIC|GR|
GREGORIAN|GREG|
GROSS|GRO|
GROSS PROFIT|GP|
GROSS PROFIT INDICATOR|GPI|
GROSS PROFIT MODELING|GPM|
GROUND|GRND|
GROUP|GRP|
GROUP RATING CLASSIFICATION CODE|GRCC|
GROUPER|GRP|
GROUPING|GRP|
GROWTH|GRWTH|
GUARANTEE|GUAR|
GUARDIAN|GRDN|
GYNECOLOGICAL|GYN|
HANDICAP|HNDCP|
HANDLING|HDLG|
HANDWRITTEN|HDWRT|
HARDKEY|HRDKY|
HARMLESS|HRMLS|
HAZARDOUS|HZRDS|
HCFA COMMON PROCEDURAL CODING SYSTEM|HCPCS|
HEAD QUARTERS|HQ|
HEADER|HDR|
HEADING|HDG|
HEALTH|HLTH|
HEALTH CARE FINANCING ADMINISTRATION|HCFA|
HEALTH CARE ORGANIZATION|HCO|
HEALTH CARE PROVIDER|HCP|
HEALTH HISTORY|HH|
HEALTH INSURANCE CLAIM NUMBER|HICN|
HEALTH MAINTENANCE ORGANIZATION|HMO|
HEALTH MAINTENANCE ORGANIZATION MINNESOTA|HMOM|
HEALTH RELATED ITEMS|HRI|
HEALTH SERVICE|HS|
HEALTH SERVICE PROVIDER|HSP|
HEALTHCARE|HC|
HEARING|HRNG|
HEIGHT|HGHT|
HELP|HLP|
HEPATIC|HPTC|
HIERARCHAL INGREDIENT CODE LIST|HICL|
HIERARCHAL INGREDIENT CODE. 6 BYTE+C238|HIC|
HIERARCHY|HRCHY|
HIGHLY COMPENSATED EMPLOYEE|HCE|
HIPAA|HIPAA|
HISTORY|HIST|
HOLD|HOLD|
HOLDER|HLDR|
HOLIDAY|HOL|
HOME|HOME|
HOME HEALTH CARE|HHC|
HOME INFUSION THERAPY|HIT|
HOMEBOUND|HMBD|
HORMONE|HRMN|
HOSPICE|HSPC|
HOSPITAL|HOSP|
HOSPITALIZATION|HOSP|
HOUR|HR|
HOURLY|HRLY|
HOURS|HRS|
HOUSE|HSE|
HUMAN|HMN|
HUMAN RESOURCE INFORMATION SYSTEMS|HRIS|
HUMAN RESOURCES|HR|
HUMIDITY|HMDTY|
IC+|IC|
ICPLUS|IC|
IDENTIFICATION|ID|
IDENTIFIER|ID|
IDENTITY|ID|
ILLEGAL|ILGL|
ILLNESS|ILL|
IMAGE|IMG|
IMMUNIZATIONS|IMUN|
IMPACTED|IMPCT|
IMPLANT|IMPL|
IMPORT|IMP|
IMPRINT|IMPRNT|
IMPROVEMENT|IMPRV|
IN NETWORK|IN|
INACTIVATION|INACT|
INACTIVE|INACTV|
INBOUND|INBD|
INCENTIVE|INCENT|
INCIDENTAL|INCID|
INCLUDE|INCL|
INCLUDED|INCL|
INCLUSIVE|INCL|
INCOME|INCM|
INCOMING|INCMG|
INCOMPETENT|INCMP|
INCREASE|INCR|
INCREMENT|INCMT|
INCREMENTAL|INCMT|
INCURRED|INCRR|
INDEMNITY|INDM|
INDEX|IDX|
INDIAN|INDN|
INDICATION|IND|
INDICATOR|IND|
INDIRECT|INDIR|
INDIVIDUAL|INDV|
INDUSTRY|INDY|
INELIGIBLE|INELG|
INFERRED|INFRD|
INFERTILITY|INFRT|
INFORMATION|INFO|
INGREDIENT|INGRD|
INGREDIENTS|INGRD|
INHOSPITAL|INHP|
INITIAL|INIT|
INITIAL PARTIAL FILL|IPF|
INITIATION|INTN|
INITIATIVE|INITV|
INITIATOR|INITR|
INJECTABLE|INJEC|
INJECTION|INJEC|
INJURY|INJ|
INNOVATOR|INVTR|
INPATIENT|IP|
INPATIENT-OUTPATIENT|IPOP|
INPUT|INP|
INPUTS|INPUT|
INQUIRY|INQ|
INSEMINATION|INSEM|
INSERT|INS|
INSERTED|INS|
INSTANCE|INSTNC|
INSTANT VALUE COUPON|IVC|
INSTITUTION|INST|
INSTITUTIONAL|INSTNL|
INSTRUCTIONS|INSTR|
INSURANCE|INS|
INSURE|INS|
INSURED|INSD|
INSURER|INSR|
INTEGRATED|INTG|
INTENSIVE CARE ANCILLARY|ICUA|
INTENSIVE CARE UNIT|ICU|
INTERACT|INTRT|
INTERCHANGE|INTCH|
INTERCOM PLUS|IC|
INTERCOM+|IC|
INTERCONTINENTAL MARKETING SERVICES - PRESCRIBER INFO|IMS|
INTEREST|INT|
INTERFACE|INTF|
INTERIM|INTRM|
INTERMEDIARY|INTMY|
INTERMEDIATE MAXIMUM|IMM|
INTERNAL|INTRL|
INTERNAL CONTROL NUMBER|ICN|
INTERNATIONAL|INTL|
INTERNATIONAL CLASSIFICATION OF DISEASE NINTH REVISION CLINICAL MODIFICATION|ICD-9-CM|
INTERNATIONAL CLASSIFICATION OF DISEASES|ICD|
INTERNATIONAL CLASSIFICATION OF DISEASES NINTH EDITION|ICD9|
INTERNATIONAL NONPROPRIETARY NAMES|INN|
INTERPLAN TELEPROCESSING SERVICE|ITS|
INTERPRETER|INTRP|
INTERROGATION|ITRGN|
INTERVAL|ITV|
INTERVENE|INTRV|
INTERVENTION|INTVN|
INTRAMUSCULAR|IM|
INTRAUTERINE|INTUT|
INTRAVENOUS|IV|
INVENTORY|INV|
INVENTORY ON HAND|IOH|
INVESTIGATION|INVST|
INVESTMENT PARTNER|IVPART|
INVOICE|INV|
INVOICED|INV|
INVOKE|INVK|
INVOKED|INVK|
INVOLVED|INVLD|
INVOLVEMENT|INVLT|
ISSUE|ISS|
ITEM|ITM|
ITERATE|ITER|
ITERATION|ITER|
JANUARY|JAN|
JOURNAL|JRNL|
JULY|JUL|
JUNE|JUN|
JURISDICTION|JRSDN|
JUSTIFICATION|JUSTF|
KEY|KEY|
KEY PERFORMANCE INDICATORS|KPI|
KIDNEY|KDNY|
KNOWLEDGE BASE DRUG CODE|KDC|
LABEL|LBL|
LABOR|LBR|
LABORATORY|LAB|
LACTATION|LCTN|
LANE|LN|
LANGUAGE|LANG|
LAST YEAR|LY|
LATITUDE|LAT|
LEADER|LDR|
LEARNING|LEARN|
LEAVE OF ABSENSE|LOA|
LEDGER|LDGR|
LEGACY|LGCY|
LEGAL|LGL|
LEGISLATION|LG|
LENGTH|LGT|
LENSE|LNS|
LENTICULAR LENSES|LNTL|
LESS THAN EFFECTIVE [TO DESI DRUGS]|LTE|
LETTER|LTR|
LETTERHEAD|LTRH|
LEVEL|LVL|
LIABILITY|LIAB|
LICENSE|LIC|
LIFETIME|LFTM|
LIMIT|LMT|
LIMITATION|LMT|
LIMITED|LMT|
LINE OF BUSINESS|LOB|
LINEAGE|LING|
LINK|LNK|
LIQUID|LQD|
LIQUOR|LIQ|
LITERATURE|LIT|
LIVING|LVG|
LOCAL|LCL|
LOCATION|LOC|
LOCATOR|LOCTR|
LOGICAL|LOGL|
LOGIN|LOGN|
LOGON|LOGON|
LONG TERM CARE|LTC|
LONGITUDE|LON|
LOOKBACK|LKBK|
LOOKUP|LKUP|
LOSS PREVENTION SUPERVISOR|LPS|
LOW INCOME SUBSIDY|LICS|
LOWER|LO|
LOWEST COST ALTERNATIVE|LCA|
MACHINE|MACH|
MAGAZINE|MGZN|
MAIL|MAIL|
MAIL ORDER|MAIL|
MAINTENANCE|MAINT|
MAJOR|MAJ|
MAJOR MEDICAL|MM|
MAJORITY|MJRT|
MAKEUP|MKUP|
MAMMOGRAM|MAMG|
MAMMOGRAPHY|MAMG|
MANAGED CARE|MC|
MANAGED CARE SYSTEM|MCS|
MANAGEMENT|MGMT|
MANAGER|MGR|
MANDATED|MNDT|
MANDATORY|MNDTY|
MANIFESTATION|MNFSN|
MANIPULATION|MANIP|
MANUAL|MANL|
MANUFACTURE|MFG|
MANUFACTURER|MFR|
MANUFACTURING|MFG|
MANUFACTUROR|MFG|
MAPPED|MAP|
MAPPING|MAP|
MARCH|MAR|
MARITAL|MRTL|
MARKET|MKT|
MARKET DEMAND GROUP / MERCHANDISE DEMAND GROUP|MDG|
MARKETING|MKTG|
MARKETING IDENTIFIER|MID|
MARKETING PRICE30|PRICE30|
MARRIAGE|MRG|
MASTER|MAST|
MASTER DRUG DATA BASE|MDDB|
MASTER TOUCH POINT|MTP|
MATCHED|MTCH|
MATERIALS|MAT|
MATERNITY|MTRN|
MAX|MAX|
MAXIMUM|MAX|
MAXIMUM ALLOWABLE COST|MAC|
MAY|MAY|
MEASURE|MEAS|
MEASUREMENT|MEAS|
MECHANICAL|MECH|
MEDCENTERS|MEDCTR|
MEDIA|MEDIA|
MEDIAN|MEDN|
MEDICAID|MCD|
MEDICAL|MED|
MEDICAL CLAIMS ANALYTICS|MCA|
MEDICAL DOCTOR|MD|
MEDICAL HEALTH PLAN|MHP|
MEDICAL SURGICAL|MS|
MEDICARE|MCRE|
MEDICARE A|MCRE_A|
MEDICARE B|MCRE_B|
MEDICARE D|MCRE_D|
MEDICARE PART A|MCRE_A|
MEDICARE PART B|MCRE_B|
MEDICARE PART D|MCRE_D|
MEDICARE SUPPLEMENT|MED SU|
MEDICATION|MED|
MEDICATION POSSESSION RATIO|MPR|
MEDISPAN|MEDSPN|
MEDI-SPAN THERAPEUTIC CLASSIFICATION REFERENCE FILE|GPIEXP|
MEDIUM|MDM|
MEETING|MTNG|
MEMBER|MBR|
MEMBERS|MNR|
MEMBERSHIP|MBRSP|
MENSTRUAL|MNSTL|
MENTAL|MNTL|
MENTAL HEALTH|MH|
MERCHANDISE|MDSE|
MESSAGE|MSG|
MESSAGING|MSG|
METHOD|METH|
METRIC|MET|
METROPOLITAN FREESTANDING|MFS|
MICROFILM|MFLM|
MIDDLE|MID|
MIDDLE INITIAL|MI|
MIDPOINT|MDPT|
MINIMUM|MIN|
MINNESOTA|MN|
MINNESOTA INDEMNITY INCORPORATED|MII|
MINOR|MNR|
MINUTES|MM|
MISCELLANEOUS|MISC|
MISMATCH|MSMH|
MIXED|MIX|
MIXTURE|MIX|
MODE|MODE|
MODEL|MDL|
MODIFIED|MOD|
MODIFIER|MOD|
MODIFY|MOD|
MODULE|MODL|
MODULUS|MDLS|
MONDAY|MON|
MONEY|MNY|
MONITOR|MNTR|
MONTH|MNTH|
MONTHLY|MNTHY|
MONTHS|MO|
MORBID|MORB|
MORBIDITY|MORB|
MULTIPLE|MULT|
MULTIPLIER|MULT|
MUNICIPALITY|MNCPLTY|
NAME|NM|
NAMED|NMD|
NARRATIVE|NAR|
NATIONAL|NATL|
NATIONAL ACCOUNTS SECURITY COMPANY|NASCO|
NATIONAL ASSOC OF BLUE SHIELD PLANS|NABSP|
NATIONAL ASSOC OF BLUE SHIELD PLANS RELATIVE INDEX|NSRVI|
NATIONAL ASSOCIATION FOR HOME CARE|NAHC|
NATIONAL ASSOCIATION OF CHAIN DRUG STORES|NACDS|
NATIONAL ASSOCIATION OF RETAIL DRUGGISTS|NARD|
NATIONAL CONTROL PLAN|NCP|
NATIONAL COUNCIL FOR PERSCRIPTION DRUG PROGRAMS|NCPDP|
NATIONAL COUNCIL ON PATIENT INFORMATION AND EDUCATION|NCPIE|
NATIONAL DRUG CODE|NDC|
NATIONAL DRUG CODE 11|NDC11|
NATIONAL PRACTITIONER IDENTIFIER|NPI|
NATIONAL PROVIDER IDENTIFIER|NPI|
NATIVE|NTV|
NATURAL|NTRL|
NATURE|NTR|
NATURE OF BUSINESS|NB|
NDC|NDC|
NECESSARY|NECSSRY|
NECESSITY|NCSY|
NEEDED|NEED|
NEGATIVE|NEG|
NEGOTIATED|NGTD|
NEGOTIATION|NGTN|
NET PAYMENT|NETPAY|
NETWORK|NTWRK|
NEW DRUG APPLICATION|NDA|
NEW YORK HEALTH CARE REFORM ACT|NYHCRA|
NEWBORN|NWBRN|
NEWSPAPER|NWSPR|
NEXTDAY|NXTDY|
NO BILL|NBIL|
NO CHECKS|NCHK|
NO EOB|NEOB|
NON PAYABLE|NPAYB|
NON-ACUTE|NACUTE|
NON-ASSIGNED|NASGN|
NONCOVERED|NCOV|
NON-COVERED|NCOV|
NON-DISCRIMINATION|NDSCRM|
NON-FORMULARY|NFM|
NON-GROUP|NGRP|
NON-HIGHLY COMPENSATED EMPLOYEE|NHCE|
NONINSURED|NINSD|
NON-INSURED|NINSD|
NON-PARTICIPATING|NPAR|
NON-REUSABLE|NRUSBL|
NON-TAXABLE|NTAX|
NORMAL WORD|NORMAL ABBREV|
NOTATION|NOTN|
NOTICE|NTE|
NOTIFICATION|NTFCN|
NOVEMBER|NOV|
NUMBER|NBR|
NURSE|NRS|
NURSERY|NRSY|
NURSING FACILITY|NRSG_FAC|
OBJECT|OBJ|
OBJECTIVE|OBJ|
OBSOLETE|OBSLT|
OBSTETRICAL|OB|
OCCUPATION|OCCP|
OCCUPATIONAL THERAPY|OT|
OCCURRENCE|OCCR|
OCTOBER|OCT|
OF|OF|
OFFICE|OFFC|
OFFICE VISIT|OV|
ON HAND|OH|
ONE HOUR|1HR|
ONLINE|ONLN|
ONSET|ONS|
ON-SITE|ONST|
OP STUDY|OPS|
OPEN|OPEN|
OPERATING|OPR|
OPERATING ROOM|OR|
OPERATION|OPRN|
OPERATOR|OPTR|
OPINION|OPIN|
OPPORTUNITY|OPPTY|
OPTION|OPT|
OPTIONAL|OPT|
ORANGE|ORANGE|
ORDER|ORDR|
ORDERING|ORD|
ORGAN|ORGN|
ORGANIZATION|ORG|
ORGANIZATIONAL|ORG|
ORIGIN|ORIG|
ORIGINAL|ORIG|
ORIGINATION|ORIG|
ORIGINATOR|ORIG|
ORTHOPEDIC|ORTHO|
ORTHOTICS|ORTHT|
OTHER|OTH|
OTHER CARRIER LIABILITY|OCL|
OTHER INSURANCE|OI|
OTHER INSURER|OI|
OUT OF NETWORK|OUT|
OUT OF POCKET|OOP|
OUT OF POCKET MAXIMUM|OOPM|
OUTBOUND|OTBD|
OUTCOME|OTCM|
OUTGOING|OUT|
OUTLIER|OUTLR|
OUTPATIENT|OP|
OUTPUT|OPUT|
OUTSTANDING|OSTDG|
OVER THE COUNTER|OTC|
OVERAGE|OVG|
OVERALL|OVRL|
OVERRIDE|OVRD|
OVERRIDES|OVRD|
OVERVIEW|OVRVW|
OWNER|OWNR|
OWNERSHIP|OWNSP|
OXYGEN|OXYG|
PACEMAKER|PMKR|
PACKAGE|PKG|
PACKED|PCKD|
PACKET|PKT|
PAID|PD|
PAID REVERSED|PD_RV|
PAIR GROUP|PGRP|
PANOGRAM|PLANO|
PARAGRAPH|PARA|
PARALLEL|PARLL|
PARAMETER|PARM|
PARENT|PRNT|
PARTIAL|PARTL|
PARTICIPANT|PRTC|
PARTICIPATING|PAR|
PARTICIPATING PLAN|PPLN|
PARTICIPATION|PAR|
PARTITION|PARTN|
PARTNER|PRTNR|
PARTNERS IN PROFIT|PIP|
PARTTIME|PT|
PARTY|PRTY|
PASSTHROUGH|PSSTHGH|
PASSWORD|PW|
PATERNITY|PTRNY|
PATH|PATH|
PATIENT|PAT|
PATIENT CLINICAL PROFILE|PCP|
PATIENT CONSULTATION MESSAGE|PCM|
PATIENT HAS ORIGINAL|PHO|
PATTERN|PTRN|
PAY|PAY|
PAYABLE|PAYB|
PAYEE|PAYE|
PAYER|PAYR|
PAYMENT|PMT|
PAYROLL|PAYR|
PEDIATRIC|PDTRC|
PENALTY|PNLTY|
PENDING|PEND|
PENETRATION|PENE|
PENSION|PNSN|
PER|PER|
PER CONTRACT PER MONTH|PCPM|
PERCENT|PCT|
PERCENTAGE|PCT|
PERFORM|PRFM|
PERFORMANCE|PRFM|
PERFORMED|PRFM|
PERIOD|PRD|
PERIODIC INTERIM PAYMENT|PIP|
PERMITTED|PMTD|
PERMUTATION|PERM|
PERSON|PERS|
PERSONAL|PERS|
PERSONNEL|PRSNL|
PHARMACEUTICAL|PHRM|
PHARMACEUTICAL CARD SYSTEM|PCS|
PHARMACEUTICAL CARE CENTERS|PCC|
PHARMACIST|RPH|
PHARMACY|PHARM|
PHARMACY BENEFIT MANAGER|PBM|
PHARMACY BENEFITS MANAGEMENT|PBM|
PHARMACY BENEFITS SYSTEM|PBS|
PHARMACY REPORT AND NEWS|PRN|
PHARMACY TECHNICIAN|PHT|
PHARMACY TECHNICIAN CERTIFICATION BOARD|PTCB|
PHONE|PHONE|
PHYSICAL|PHY|
PHYSICIAN|PHYS|
PHYSICIANS DESK REFERENCE|PDR|
PICKUP|PKUP|
PICTURE|PIC|
PLACE|PL|
PLACEMENT|PLMNT|
PLAN|PLN|
PLANNED|PLAND|
PLANNING|PLNG|
PLANOGRAM|PLNGRM|
PLANOGRAM LINK NUMBER|PLN|
POINT|PNT|
POINT OF PURCHASE|POP|
POINT OF SALE|POS|
POINTER|PTR|
POINTS|PTS|
POLICY|PLCY|
POLITICAL|PLTCL|
POPULATION|POP|
PORTABILITY|PORT|
PORTAL|PRTL|
POS|POS|
POSITION|POSN|
POSITIVE|POSV|
POSSESSION|PSSN|
POSSIBLE|PSSBL|
POST OFFICE|PO|
POST OFFICE BOX|POBOX|
POST VOID TRANSACTION|PVOID|
POSTAGE|PSTG|
POSTAL|PSTL|
POSTDIRECTIONAL|PSDIR|
POSTED|POSTD|
POSTNATAL|PSTNTL|
POSTPONEMENT|POSTPN|
POTENTIAL|POTNL|
PRACTICE|PRAC|
PRACTIONER|PRACR|
PRACTITIONER|PCTNR|
PREADJUDICATED|PRADJU|
PREADMISSION|PRADM|
PREADMISSION NOTIFICATION|PAN|
PREAUTHORIZATION|PA|
PREBURSTED|PBURT|
PRE-BURSTED|PBURT|
PRECAUTION|PCTN|
PRECEDING|PREC|
PRECERTIFICATION|PAN|
PREDIRECTIONAL|PRDIR|
PRE-EXIST|PREX|
PREFERENCE|PREF|
PREFERRED|PREF|
PREFERRED PROVIDER ORGANIZATION|PPO|
PREFIX|PFX|
PREGANCY|PREG|
PREGNANCY|PGNCY|
PRELIMINARY|PRLIM|
PREMIUM|PREM|
PRENATAL|PRNTL|
PREOPERATIVE|PREOP|
PREPAID|PRPD|
PREPARATION|PREP|
PRERECORDED|PRCD|
PRESCRIBED|PBD|
PRESCRIBER|PBR|
PRESCRIBING|PRESCRIBING|
PRESCRIPTION|RX|
PRESCRIPTION DRUG|RX|
PRESCRIPTION DRUG EVENT|PDE|
PRESSURE|PRSSR|
PREVAILING|PRVL|
PREVENTIVE|PRVNTV|
PREVIOUS|PREV|
PRICE|PRC|
PRICE30|PRICE30|
PRICING|PRC|
PRIMARY|PRIM|
PRIMARY CARE CLINIC|PCC|
PRIMARY CARE PROVIDER|PCP|
PRIME THERAPEUTICS|PTP|
PRINCIPAL|PRN|
PRINT|PRT|
PRINTER|PRINTR|
PRINTS|PRINT|
PRIOR|PRR|
PRIOR ADVERSE REACTIONS|PARTM|
PRIOR AUTHORIZATION|PA|
PRIORITY|PRITY|
PRIVATE|PVT|
PRIVILEGE|PRIVILEGE|
PROBATION|PRBTN|
PROBLEM|PRBL|
PROCEDURAL|PROC|
PROCEDURE|PROC|
PROCESS|PRCS|
PROCESSED|PRCS|
PROCESSING|PRCS|
PROCESSOR|PRCS|
PRODUCED|PRDCD|
PRODUCT|PROD|
PRODUCT DESCRIPTION ABBREVIATION|PDA|
PRODUCT IDENTIFICATION NUMBER|PIN|
PRODUCTION|PROD|
PRODUCTIVE|PRODV|
PROFESSIONAL|PROF|
PROFICIENCY|PROFC|
PROFILE|PROFILE|
PROFIT|PFT|
PROGNOSIS|PX|
PROGRAM|PGM|
PROJECT|PROJ|
PROJECTED|PROJ|
PROMISED|PROMIS|
PROMO|PROMO|
PROMOTION|PROMO|
PROMOTIONAL LOCATION MAINTENANCE|PLM|
PROMOTIONAL MERCHANDISE MANAGER|PMM|
PROMOTIONAL MONEY|PM|
PROMPT|PRMPT|
PROPERTY|PRPTY|
PROPOSED|PROP|
PROPRIETARY|PRPRT|
PRORATED|PROR|
PRORATION|PRRTN|
PROSPECT|PRSP|
PROSTATE|PRST|
PROSTHETICS|PRTHT|
PROTECTED|PROTCT|
PROTECTION|PROTN|
PROVIDED|PRVD|
PROVIDER|PRV|
PROVINCE|PRVNC|
PROVISION|PRVS|
PSYCHIATRIC|PSYCH|
PSYCHIATRIST|MD|
PSYCHOLOGIST|PSYCH|
PUBLIC|PUBL|
PUBLIC HEALTH SERVICE|PHS|
PUBLIC RELATIONS|PR|
PUBLICATION|PUBL|
PUBLISH / PUBLIC|PUB|
PUBLISHING|PUBL|
PULMONARY|PLMNRY|
PURCHASE|PRCH|
PURGE|PRG|
PURPOSE|PRPS|
PUTAWAY|PUTWY|
QUALIFICATION|QLFN|
QUALIFIED|QFD|
QUALIFIED PLAN CODE|QPC|
QUALIFIER|QLFR|
QUALIFYING|QLFY|
QUALITY ASSURANCE|QA|
QUANTITY|QTY|
QUARTER|QTR|
QUARTERLY|QTRLY|
QUERY|QRY|
QUESTION|QSTN|
QUEUE|QUE|
QUOTE|QTE|
RADIATION|RADN|
RADIOLOGY|RAD|
RANGE|RNG|
RANK|RANK|
RATE|RATE|
RATE -BEN ENG|RT|
RATING|RTNG|
READJUDICATED|RADJUD|
READJUDICATION|RADJUD|
READMISSION|READM|
READY|RDY|
REAL ESTATE COMMITTEE|REC|
REALTIME|RLTM|
REASON|RSN|
REASSIGNED|RASGN|
REBATABLE|REB|
REBATE|REB|
REBATEABLE|REB|
RECEIPT|RCPT|
RECEIVED|RCVD|
RECEIVER|RCVR|
RECEIVING|RCVNG|
RECENT|RCNT|
RECIPIENT|RCPNT|
RECLOSURE|RCLSR|
RECOGNITION|RCGN|
RECOGNIZE|RCGZ|
RECOGNIZED|RCGZ|
RECOMMEND|RCMD|
RECOMMENDATION|RCMD|
RECOMMENDED|RCMD|
RECONCILE|RECNCL|
RECONCILIATION|RECN|
RECONSTRUCTIVE|RECON|
RECORD|REC|
RECOUPMENT|RCPMNT|
RECOVERED|RCVR|
RECOVERY|RCVR|
RECREATIONAL|RCRTNL|
RECREDENTIALED|RCRD|
RECYCLE|RCYCL|
REDEFINE|REDF|
REDEMPTION|REDMPTN|
REDUCE OUR DAYS OF SUPPLY|RODS|
REDUCED|RDC|
REDUCTION|RED|
REFERENCE|REF|
REFERRAL|REF|
REFERRING|RFRNG|
REFUND|RFND|
REGION|RGN|
REGIONAL|RGN|
REGISTER|RGSTR|
REGISTERED NURSE|RN|
REGISTRY|RGSTRY|
REGULAR|REG|
REGULATOR|RGLR|
REGULATORY|RGLR|
REHABILITATION|REHAB|
REHABILITATIVE|REHAB|
REIMBURSE|REMB|
REIMBURSED|REMB|
REIMBURSEMENT|REMB|
REINITIATE|RINTN|
REINSTATE|REI|
REINSTATEMENT|REIMT|
RE-INSURANCE|REINS|
REINSURED|REINS|
REJECT|REJ|
REJECTED|REJ|
REJECTION|REJ|
RELATED|REL|
RELATION|REL|
RELATIONSHIP|REL|
RELATIVE|RLTV|
RELEASE|RLSE|
RELINQUISHED|RLNQ|
RELOAD|RLD|
REMAIN|REMN|
REMAINING|REMN|
REMARK|RMK|
REMARKS|RMRK|
REMINDER|RMDR|
REMITTANCE|REMT|
REMOVE|RMV|
RENDERING|RNDR|
RENEW|RNW|
RENEWAL|RNWL|
RENTAL|RNTL|
REOPEN|REOP|
REORDER|REORDER|
REPACK|RPK|
REPACKAGE|RPKG|
REPAID|REPD|
REPLACED|RPLC|
REPLACEMENT|RPLCM|
REPORT|RPT|
REPORTED|REPORTD|
REPORTING|RPT|
REPRESENTATIVE|REP|
REPRICED|RPRC|
REPROCESS|RPRCS|
REPROCESSED|RPRCSD|
REQUEST|REQ|
REQUESTED|REQ|
REQUESTOR|RQSTR|
REQUIRED|REQ|
REQUIREMENT|REQ|
RESENT|RSNT|
RESERVE|RSRV|
RESERVED|RSRV|
RESIDENCE|RSDNC|
RESIDENT|RSDNT|
RESIDENTIAL|RSDNTL|
RESIDUAL|RSDL|
RESOLUTION|RSLTN|
RESOLVE|RSLV|
RESOURCE|RSRC|
RESPIRATION|RSPTN|
RESPITE|RSPT|
RESPONSE|RESP|
RESPONSIBILITY|RSPBL|
RESPONSIBLE|RSPBL|
RESTRICTION|RSTR|
RESUBMISSION|RSUMB|
RESULT|RSLT|
RETAIL|RETL|
RETAIN|RETN|
RETENTION|RETNN|
RETIREE|RETE|
RETIREE DRUG SUBSIDY|RDS|
RETIREMENT|RETMT|
RETROACTIVE|RETRO|
RETROSPECTIVE|RTRSP|
RETURN|RTRN|
RETURN GOODS MERCHANDISE|RGM|
REUSABLE|RUSBL|
REVENUE|REV|
REVERSAL|RVRS|
REVERSE|RVRS|
REVERSED|RVRS|
REVIEW|RVW|
REVIEWER|RVWR|
REVISE|RVS|
REVISION|RVSN|
REVOKE|RVK|
REWARDS|REWARD|
RIDER|RDR|
RISK EVALUATION COMPONENT|REC|
ROLL OVER|ROVR|
ROOM|RM|
ROOM AND BOARD|RMBD|
ROUNDING|RND|
ROUTE|RT|
ROUTINE|RTN|
ROUTING|RTG|
RULE|RULE|
RUN OUT|ROUT|
RURAL|RURAL|
RX|RX|
RX DATA WAREHOUSE|RXDW|
SALARY|SLRY|
SALE|SLS|
SALES|SLS|
SALESMAN|SMAN|
SAME AS|SA|
SAMPLE|SMP|
SATISFACTION|SATF|
SATISFIED|SATF|
SATURATION|SATR|
SATURDAY|SAT|
SAVINGS|SAV|
SCANNED|SCAN|
SCANNER|SCANR|
SCHEDULE|SCHED|
SCHOOL|SCHL|
SCIENCE|SCNC|
SCLEROSING|SCLR|
SCORE|SCOR|
SCREEN|SCR|
SCREENING|SCR|
SEARCH|SRCH|
SEASONAL|SESONL|
SECOND|SEC|
SECONDARY|SECNDRY|
SECONDS|SEC|
SECTION|SECT|
SECURITY|SCTY|
SEGMENT|SEG|
SELECT|SEL|
SELECTED|SEL|
SELECTION|SELN|
SELF INSURED|SI|
SELL|SELL|
SELLER|SELLR|
SEMINAR|SMNR|
SEMI-PRIVATE|SEMPRI|
SENDER|SNDR|
SENDING|SENDING|
SENDS|SEND|
SENIOR|SR|
SENSITIVITY|SNTVTY|
SEPARATE|SPRT|
SEPARATOR|SEP|
SEQUENCE|SEQ|
SEQUENTIAL|SEQ|
SERIAL|SER|
SERIES|SER|
SERVICE|SERV|
SERVICES|SERV|
SESSION|SES|
SETS|SET|
SETTLEMENT|STLM|
SEVERITY|SVTY|
SEXUAL|SXL|
SHARE|SHR|
SHAREABLE|SHRBL|
SHARED|SHR|
SHARING|SHR|
SHIP|SHIP|
SHIPMENT|SHIP|
SHIPPED|SHIP|
SHOES|SHS|
SHORT|SHRT|
SHORTAGE|SHRTG|
SIGNATURE|SIG|
SIMILAR|SIM|
SINGLE|SGL|
SITE|SITE|
SIZE|SZ|
SIZING|SZ|
SKILL|SKL|
SKILLED|SKL|
SKILLED NURSING FACILITY|SNF|
SMALL GROUP|SMGRP|
SMALLEST|SMLST|
SMART|SMRT|
SMOKE|SMK|
SMOKING|SMKNG|
SOCIAL SECURITY NUMBER|SSN|
SOFTWARE|SW|
SOLD|SLD|
SOLUTION|SOLU|
SOLVING|SLV|
SOUND|SO|
SOURCE|SRC|
SOUTH DAKOTA|SD|
SPECIAL|SPCL|
SPECIAL INSTRUCTIONS GROUP|SIG|
SPECIALIST|SPCT|
SPECIALTY|SPCLTY|
SPECIFIC|SPC|
SPEECH THERAPY|SPTH|
SPEED|SPEED|
SPENDING|SPNDNG|
SPINAL|SPNL|
SPONSORED|SPSR|
SPOUSE|SP|
SQUARE|SQR|
STAFF|STF|
STAGE|STG|
STAGING|STG|
STAMP|STMP|
STANDARD|STD|
STANDARD DRUG DATA BASE|SDDB|
STANDARD DRUG DATA BASE-PLUSTM|SDDB-PLUS|
STANDARD INDUSTRY CLASSIFICATION|SIC|
STANDARD OPERATING PROCEDURE|SOP|
START|STRT|
STARTING|STRTN|
STATE|ST|
STATEMENT|STMT|
STATION|STN|
STATISTICAL|STATL|
STATISTICS|STATS|
STATUS|STAT|
STATUTORY|STTRY|
STEPCHILD|STCHD|
STERILIZATION|STRLN|
STEWARD|STWD|
STOP LOSS|SL|
STORE|STR|
STORE ACTION INQUIRY LINE|SAIL|
STORE KEEPING UNITS|SKU|
STRATEGIC BUSINESS UNITS|SBU|
STRATEGY|STRGY|
STREAM|STRM|
STREET|STR|
STRENGTH|STRENGTH|
STRETCHER|STCHR|
STRUCTURE|STRU|
STUDENT|STU|
STYLE|STY|
SUBCASE|SUBCS|
SUBCATEGORY|SCATG|
SUBCLASS|SBCLS|
SUBCLASSIFICATION|SUBCLASS|
SUBDIVISION|SDIV|
SUBGROUP|SUBGR|
SUBJECT|SUBJ|
SUBLUXATION|SBLX|
SUBMISSION|SUBM|
SUBMIT|SUBM|
SUBMITTED|SUBM|
SUBMITTER|SUBM|
SUBORDINATE|SBORD|
SUBPROJECT|SUBPRJ|
SUBSCRIBER|SUB|
SUBSEQUENT|SUBQ|
SUBSIDIARY|SBSRY|
SUBSIDIZE|SBSDZ|
SUBSIDIZED|SBSDZ|
SUBSIDY|SBSDY|
SUBTASK|SUBTK|
SUBTOTAL|SBTOT|
SUCCESS|SUCC|
SUFFIX|SUFX|
SUGGEST|SUGST|
SUGGESTED|SUGSTD|
SUMMARY|SUMR|
SUMMARY PLAN DESCRIPTION|SPD|
SUNDAY|SUN|
SUPERVISING|SUPV|
SUPERVISOR|SUPV|
SUPPLEMENTAL|SUPP|
SUPPLIED|SUPPL|
SUPPLIER|SPLR|
SUPPLIES|SPLS|
SUPPLY|SPLY|
SUPPORT|SPPRT|
SUPPORTED|SUPPRTD|
SUPPRESS|SPRS|
SURGERY|SURG|
SURGICAL|SURG|
SURROGATE KEY|SK|
SURVIVING|SURV|
SUSPEND|SUSP|
SUSPENSE|SUSP|
SWITCHING|SWTCH|
SYMPTOM|SYMT|
SYNOPSIS|SYN|
SYSTEM|SYS|
SYSTEM FOR TIMELY AUTOMATED RESOLUTION|STAR|
TABLE|TBL|
TAG|TAG|
TAKE HOME DRUGS|THD|
TAKE OVER|TKOVR|
TAKEN|TAKEN|
TALK|TALK|
TALLY|TLY|
TANDEM|TANDEM|
TARGET|TGT|
TAX IDENTIFICATION NUMBER|TIN|
TEACHING|TCHNG|
TECHNICAL|TECH|
TECHNICAL ATTRIBUTE|TECAT|
TELECOMMUNICATION|TCOM|
TELECOMMUNICATIONS|TELCOM|
TELEPHONE|PHONE|
TELEVISION|TV|
TEMPERATURE|TEMP|
TEMPLATE|TMPLT|
TEMPORAL MANDIBULAR JOINT|TMJ|
TEMPORARY|TEMP|
TEMPORARY|TMP|
TENDER|TNDR|
TERM|TERM|
TERMINAL|TRML|
TERMINATE|TRMN|
TERMINATED|TRMD|
TERMINATION|TRMN|
TERMINOLOGY|TRMGY|
TERRITORY|TER|
TERTIARY|TRTY|
TEST|TST|
TESTER|TSTR|
TESTING|TST|
TEXT|TXT|
THERAPEUTIC|THRPC|
THERAPEUTIC CLASSIFICATION REFERENCE FILE|TCRF|
THERAPEUTIC CLASSIFICATION SYSTEM|TCS|
THERAPEUTIC EQUIVALENCE EVALUATION|TEE|
THERAPY|THRPY|
THERAPY PROTOCOL MANAGEMENT|TBM|
THIRD|3RD|
THIRD PARTY|3PTY|
THIRD PARTY ADJUDICATION|TPA|
THIRD PARTY ADMINISTRATOR|TPA|
THIRD_PARTY_AGENCY|TPA|
THIS YEAR|TY|
THREE-UPS|3-UPS|
THRESHOLD|THRES|
THROUGH|THRU|
THURSDAY|THU|
TICKET|TKT|
TIER FIVE|T5|
TIER FOUR|T4|
TIER ONE|T1|
TIER THREE|T3|
TIER TWO|T2|
TIME|TM|
TIMELINESS|TMLNS|
TIMELY|TM|
TIMESTAMP|TS|
TIMEZONE|TZ|
TISSUE|TIS|
TITLE|TTL|
TO|TO|
TOBACCO|TBCC|
TOLERANCE|TLRNC|
TOLL FREE|TOL|
TOTAL|TOT|
TOUCH POINT|TP|
TRACKING|TRK|
TRADING|TRDG|
TRAIL|TRL|
TRANSACTION|TXN|
TRANSFER|XFER|
TRANSFERRED|XFER|
TRANSFERRED FROM ORIGINAL PRESCRIPTION BLANK|TFORXB|
TRANSFORM|TRNSF|
TRANSFORMED|TRNSF|
TRANSIT|TRN|
TRANSITION|TRN|
TRANSITIONAL|TRNL|
TRANSLATION|TRNSL|
TRANSMISSION|XMSN|
TRANSMIT|XMT|
TRANSMITTAL|XMTL|
TRANSPLANT|TRPL|
TRANSPLANT PAYMENT ALLOWANCE|TRPL P|
TRANSPLANT PAYMENT ALLOWANCE -BEN ENG|TPA|
TRANSPORT|TRPT|
TRAVEL|TRVL|
TRAVELER|TRVLR|
TREATMENT|TRMT|
TREND|TRND|
TRIAGE|TRIG|
TRIFOCAL|TRFCL|
TRIGGER|TRIGGER|
TRUE OUT OF POCKET EXPENSE|TROOP|
TRUSTEE|TRST|
TUESDAY|TUE|
TURNAROUND|TRNRND|
TXN|TXN|
TYPE|TYP|
UC LOB|UCLOB|
ULTIMATE|ULT|
UNALLOCATE|UALOC|
UNALLOCATED|UALOC|
UNBREAKABLE|UBKBL|
UNBUNDLED|UBNDL|
UNDER|UNDR|
UNDERWRITING|UW|
UNEMPLOYMENT|UNEMP|
UNIFORM BILLING 92|UB92|
UNIFORM SYSTEM OF CLASSIFICATION|USC|
UNIQUE|UNIQ|
UNIQUE IDENTIFIER|UI|
UNIT DOSE/UNIT OF USE|UD/UU|
UNIT OF MEASURE|UOM|
UNITED STATES ADOPTED NAME|USAN|
UNITED STATES DEPARTMENT OF HEALTH AND HUMAN SERVICES|USDHHS|
UNITED STATES PHARMACOPEIA DISPENSING INFORMATION|USP DI|
UNITED STATES PHARMACOPEIA NATIONAL FORMULARY|USP-NF|
UNITED STATES PHARMACOPEIAL CONVENTION, INC.|USPC|
UNITS|UNITS|
UNIVERSAL|UNV|
UNIVERSAL CLAIM FORM|UCF|
UNIVERSAL MAPPING TOOL|UMT|
UNIVERSAL PRODUCT CODE|UPC|
UNKNOWN|UNKN|
UNLOAD|UNLD|
UNMATCHED|UMTCH|
UNREPLACED|UNRPL|
UNSIGNED|UNSG|
UP|UP|
UPC|UPC|
UPDATE|UPDT|
UPDATED|UPDT|
UPFRONT|UPFR|
UPI|UPI|
UPLOAD|UPLD|
UPPER|UP|
USAGE|USAG|
USERID|UID|
USUAL & CUSTOMARY|UC|
USUAL CUSTOMARY AND REASONABLE|UCR|
UTILITY|UTIL|
UTILIZATION|UTLZ|
UTILIZATION THERAPY MANAGEMENT|UTM|
UTILIZED|UTLZ|
UTILIZING|UTLZ|
VACCINATION|VCCNTN|
VALID|VLD|
VALIDATE|VALDT|
VALIDATED|VALDT|
VALIDATION|VLDTN|
VALUE|VAL|
VALUE BASED INSURANCE DESIGN|VBID|
VALUES|VAL|
VARIABLE|VRBL|
VARIANCE|VAR|
VARIATION|VARN|
VENDOR|VEND|
VENTILATION|VENTL|
VENTILATOR|VENT|
VERBAL|VRBL|
VERIFICATION|VERIF|
VERIFIED|VERIF|
VERSE|VS|
VERSION|VERS|
VISION|VIS|
VISIT|VST|
VOCATIONAL|VOCTN|
VOLUNTARY|VLNTRY|
VOTING|VTG|
VOUCHER|VCR|
VOUCHERED|VCR|
WAITING|WTG|
WAIVE|WV|
WAIVE PEND|WPND|
WAIVED|WVD|
WAIVER|WVR|
WALGREENS|WAG|
WALGREENS ACQUISITION COST|WAC|
WALGREENS CORPORATE|WAG|
WALGREENS HEALTH INITIATIVES|WHI|
WALGREENS ITEM CODE|WIC|
WARDS|WRDS|
WAREHOUSE|WHSE|
WARNING|WRNG|
WARRANTY|WNTY|
WEDNESDAY|WED|
WEEK|WK|
WEEK END|WK_END|
WEEKDAY|WKDAY|
WEEKLY|WKLY|
WEIGHT|WGT|
WEIGHTED|WGTD|
WELFARE|WLFR|
WELL CHILD|WCHD|
WELLNESS|WELLN|
WHITE|WHT|
WHOLE|WHL|
WHOLESALE|WHSL|
WHOLESALE COST|WHAC|
WHOLESALER ACQUISITION COST|WAC|
WIC|WIC|
WILLING|WLLNG|
WINDOW|WNDW|
WITH|W|
WITHDRAW|WITHDRAW|
WITHDRAWAL|WDRAW|
WITHHOLDING|WTHG|
WITHOLD|WTHD|
WITHOUT|WO|
WORK|WRK|
WORK BREAKDOWN STRUCTURE|WBS|
WORKER|WKR|
WORKERS COMPENSATION|WC|
WORKING|WKG|
WORKMANS COMPENSATION|WC|
WORKSTATION|WORKSTATION|
WORLD HEALTH ORGANIZATION|WHO|
WORLD WIDE RETAIL EXCHANGE|WWRE|
WRAP UP|WRPUP|
WRAP_UP|WRPUP|
WRITTEN|WRTN|
YEAR|YR|
YEAR TO DATE|YTD|
YELLOW PAGES|YLWPGS|
ZIP|ZIP|
ZONE|ZONE|
