ID3|???|
3AI|TPL Alt ID Detail|
3AL|TPL Alternate ID List|
3EX|3rd Party Exception|
3PR|Third Party Response|
3SC|TPL Source Code List|
3SD|TPL Source Code Dtl|
3SI|TPL Source ID Detail|
3SL|TPL Source ID List|
998|Select Mbr Cnv WRKFL|
999|DSC/OOP Cnv WRKF|
AAH|AccumSavAcct Archv HR|
AAL|AccumSavAcct Archv Lg|
AC1|Account Extension 1|
ACC|Account|
ACL|Account List|
ACM|Accumulation Code|
ACP|Alt Copay PSC Overrid|
AD1|Adj Reason Code List|
AD2|Adj Rsn Cde Lst Dtl|
ADC|Adjudication Control|
ADD|Amt Due Sched Step|
ADE|Adjustment Dtl Extr|
ADH|Allowed DEA Sched HDR|
ADJ|Adjustment Reason|
ADN|Amt Due Sched Notes|
ADR|Alow Drug Schd forDEA|
ADS|Amount Due Schedule|
ADX|Amount Due Sched Ext|
AF1|Auto File Ctrl|
AF2|Auto File Processing|
AF3|EDI Data for Pyr/Pyee|
AFC|Admin Fee Criteria|
AFD|Affiliation List Dtl|
AFF|Relationship|
AFH|Admin Fee Profile Hdr|
AFI|Admin Fee Prof Items|
AFL|Affiliation List|
AFN|Affiliation Notes|
AFP|Admin Fee Profile|
AFR|Admin Fee Profile|
AFS|Admin Fee Schedule|
AFU|Admin Fee Prof Sched|
AGC|Ancillary Grp ID Card|
AGD|Ancillary Group Data|
AGE|Allergy List Detail|
AGF|Ancillary Grp Flds|
AGL|Allergy List|
AGV|Ancillary Grp VldList|
AH1|AHS Plan to Exclude|
AHC|AHCCCS Phys X-Ref|
AHF|AHFS Class|
AHP|AHCCCS Pharmacy X-Ref|
AHS|RxCLAIM Interface|
AID|Alt Ins Type Detail|
AIL|Alt Ins Type List|
AJ1|Adjustment Type|
AJ2|Adjustment List|
AJ3|Adjustment Entry|
AJ4|Adjustment Cycle|
AJN|Adjustment List Notes|
AJO|Adj Entry Notes|
AJR|Adjustment Reporting|
AJT|Adj Client Types|
AL1|Accumulation Code Lst|
AL2|Accum Code List Dtl|
ALD|Account List Detail|
ALG|Allergy|
ALH|Archive Log Header|
ALS|Adjstmnt Log Seg DspF|
AMC|Ancillary Mbr Id Card|
AMD|Ancillary Member Data|
AME|Neutral Amendment Ext|
AMF|Ancillary Mbr Flds|
AMI|Alternate Member ID|
AMJ|Mass Amndmnt Job Dtl|
AML|Amendment Linked Dtl|
AMN|Amendment Neutral Dtl|
AMQ|Mass Amndmnt Qual Clm|
AMR|Mass Amndmnt Clm Rslt|
AMS|Mass Amndmnt Sel Parm|
ANO|Account Notes|
AOC|AccumOvrdScd Criteria|
AON|Accum Ovrd Scde Notes|
AOS|Accumulator Ovrd Scde|
AP1|Accum Adj Prfl PreLod|
AP2|Accum Adj Prfl Validt|
APC|Drug Dosage Check Inf|
APF|Application Profile|
APL|Audit Plan File|
APN|Addl Pat Pay Notes|
APO|App Profile Note|
APP|Addl Patient Pay|
APS|Addl Pat Pay Sched|
APT|Addl PatPaySched Stps|
APX|Rel/Payee Cross Ref|
AR1|Claim Adjust Reason|
ARC|Auto Resubmit Claim|
ARN|CMS Appeal Rights Ntc|
ASB|Assignmnt of Benefits|
ASD|AssgnmtOfBenefits Dtl|
ASH|Admin Fee Sched Hdr|
ASI|Admin Fee Sched Items|
ASN|AssgnmtOfBenefitsNote|
ASX|Addl Pat Pay Sch Ext|
AU1|Audit Master File|
AU2|Audit Master Fields|
AXT|RxACT DTQ Extract|
BAC|Benefit Max Alt Copay|
BCC|DDC Batch Control Fil|
BCD|DDC Batch Control Dtl|
BCE|DDC Detail Errors|
BCH|DDC Batch Control Hdr|
BCP|DDC Batch Contrl Parm|
BDD|Ben Max Drug Sts Det|
BDE|BrandDisc AccumSchDtl|
BGP|Brand Generic Pat Pay|
BL1|BIN/PCN/Group List|
BL2|BPG List Detail|
BLR|Boilerplate Destinati|
BLW|Batch Load Work File|
BM0|Batch Manual Claim|
BM1|Batch Manual Clm Dtl|
BMD|Ben Max Drug Sts Sch|
BMW|Batch Manual WrkFile|
BND|Beneficiary Cost Dtl|
BNI|Bene Cost Item File|
BNS|Beneficiary Cost Schd|
BPC|BIN/ProcCtl Assignmnt|
BPG|Bin PC Nbr Grp Trans|
BPN|Benefit Plan Notes|
BPR|Secondary BPG Rejects|
BPT|Benefit Plan Translat|
BPX|Bin PC Nbr Grp Extend|
BPY|Bin PC Nbr Grp Ext 2|
BQ0|Batch Elig Query|
BQ1|Batch Elig Query 1|
BQ2|Batch Elig Query 2|
BQ3|Batch Elig Query 3|
BSC|Benefit Sch Ctrl|
BSD|Benefit Schedule Dtl|
BSN|Benefit Sch Ctl Notes|
C2P|Capt Claim w/Paid Rsp|
CA1|Carrier Extension 1|
CA2|Carrier Extension 2|
CAC|Carrier Audit Claims|
CAD|Claim Pharmacy Adj|
CAE|Cov PlnPay AccSch Dtl|
CAG|Process Settings|
CAL|RxCLAIM Calendar|
CAM|Client Access to MAC|
CAN|Carr/Acc/Group Notes|
CAP|Prod by Carr Work Fil|
CAR|Carrier|
CBP|COB Paid|
CBR|COB Reject|
CBS|COB/Oth PayerBenStage|
CCA|Copay Calc Cd Applied|
CCD|County Code Detail|
CCF|Client Code File|
CCL|County Code List|
CCN|Client Comm Prof Note|
CCO|Client Comm Profile|
CCR|ClmCreditCardReq&Resp|
CCT|Claim Call Types|
CDE|Pln Cmpnd DESI|
CDG|Carrier Drug Status|
CDM|Compound Detail Msg|
CDO|Carrier Disaster Ovr|
CDS|Comm Detail Stats|
CDT|Code Table|
CEA|Clm Mbr Ref EOB Addr|
CEL|Claim Engine Level|
CES|Carrier Extract Selec|
CET|Job Log File|
CFA|Care Facility|
CFC|Care Facility Counts|
CFG|QA Process Config|
CFI|Carrier Financial ID|
CFL|Care Facility List|
CFT|Care Facility Lst Tbl|
CG1|Cont Ther GPI List|
CGD|Group COB Addt Detail|
CGP|Coverage Group PCN|
CH2|Check Output File|
CH3|Check Output File|
CHN|Claim History Notes|
CHO|Check Output File|
CID|Client ID|
CK1|Pharmacy Check File|
CK2|Member Check File|
CK4|DMR Check File (Rev)|
CL1|Call Type List|
CL2|Call Type List Dtl|
CL3|CMS Labeler List Dtl|
CL4|Customer Location Lst|
CL5|Customer Location Dtl|
CLC|Customer Location|
CLD|Call Tracking Detail|
CLF|Communication Log Fil|
CLH|Call Tracking Header|
CLI|Clinical Information|
CLL|CMS Labeler List|
CLO|Clarification Ovrd|
CMA|CM Archive Log|
CMB|Comp Mult-Ing Dtl RxB|
CMC|Copay Min/Max Calc Cd|
CMD|Compound Mult-Ing Dtl|
CME|Pln Cmpnd Medicaid|
CMI|Pln Compound Mult-Ing|
CMM|Copay Min/Max Pricing|
CMP|Compounds|
CMR|Claim Member Refund|
CN1|Cont Ther NDC List|
CNL|Ceiling Prc NDC List|
CNO|Carrier Notes|
CNP|Care Network/Provider|
CNV|Ceiling Prc NDC Value|
CNW|Care Network|
CO1|Coord of Ben Response|
CO2|Chk Output Dtl (Rev)|
CO3|Chk Output Dtl|
COB|Coordination of Ben|
COG|Group COB Options|
COP|COB/OthPyrPatRspiblty|
COS|Cost Source|
COT|Cost Type|
CPA|Covered Plan Pay Amt|
CPB|Cntract/PBP/BenYr Tbl|
CPC|CTH Purge Control|
CPD|Ph Cst Price Schd Dtl|
CPE|Contract PBP List Dtl|
CPH|CTH Purge History|
CPL|Contract PBP List|
CPO|Claim Payee Override|
CPP|Pharm Cost Price Schd|
CPQ|Claim Plan Qualifier|
CPR|CTH Purge Reporting|
CPS|Coupon Segment|
CPV|Contract PBP Validate|
CQU|Care Qualifier|
CRA|Claim Mbr Refund Addr|
CRB|Cmrcl Reproc Load|
CRC|Cmrcl Reproc Claim|
CRD|Carrier List Detail|
CRH|Cmrcl Reproc Claim Hs|
CRJ|Compound Reject|
CRL|Carrier List|
CRM|Cmrcl Reproc Mass Sel|
CRP|Cmrcl Reproc Job|
CRW|Cmrcl Reproc Input WK|
CSC|Copay Schedule|
CSD|Customer List Detail|
CSF|Compound Prf Srv Fee|
CSG|Client Segment|
CSH|Copay Schedule Header|
CSL|Customer List|
CSM|Cont Therapy Message|
CSN|Copay Schedule Notes|
CSP|Cont Ther Sched Prtcl|
CSR|Controlled Subst Rpt|
CSS|Cost Source & Type|
CST|Communication Stats|
CSX|Copay Sched Hdr Ext|
CTH|Claims Trans History|
CTL|Claims Trans Lifetime|
CTN|Cont Therapy Sch Note|
CTS|Cont Therapy Schedule|
CTY|FIPS County|
CUS|Prod Cost Upd Suppres|
CW3|CMS Labeler LstDtlWrk|
CWC|Carrier W/C Carrier|
CWP|Check Writing Program|
CXD|CAG X-Ref List Dtl|
CXL|CAG X-Ref List|
CXR|Client Cross Ref|
D00|DUR Parameter Table|
D01|ALLERCHK Parm Table|
D02|COMPLIAN Parm Table|
D03|DDI-DTMS Parm Table|
D04|DIAGCAUT Parm Table|
D05|DINFERRD Parm Table|
D06|DOSECHEK Parm Table|
D07|DRUGAGE Parm Table|
D08|DrugSex Parm Table|
D09|DTHERAPY Parm Table|
D10|DUPTHER Parm Table|
D11|ACTMAINT Parm Table|
D12|USERRTN Parm Table|
D13|THERDOSE Parm Table|
D3X|Drug Cost Sched Ext|
D5X|Drug Cost Com Sch Ext|
D6D|DOSECHEK Override Dtl|
D6L|DOSECHEK Override Lst|
D6N|DOSECHEK Ovr Dtl Note|
D7D|DRUG_AGE Override Dtl|
D7L|DRUG_AGE Override Lst|
D7N|DRUGAGE Ovr Dtl Note|
DA0|Daily Activity File|
DA1|Daily Activity Event|
DA2|Daily Activity LATE|
DA3|Daily Activity LICS|
DA4|Daily Activity PBP|
DA5|Daily Activity PCO|
DA6|Daily Activity PREM|
DA7|Daily Activity PRTD|
DA8|Daily Activity RAFT|
DAE|Dependent Age Edit|
DAL|Drug Appl ID Link|
DAM|Drug Appl ID Mfr|
DAR|Data Area Resource|
DAS|Drug Appl ID Summary|
DBD|DBREAD Data Element|
DBP|Disbursement Payer|
DBT|Database Trigger Ctl|
DC1|Data Collect Log Hdr|
DC2|Data Collect Carr Tot|
DC3|Drug Cost Schedule|
DC4|DrugCostSchedCriteria|
DC5|Drug Cost Comp Sched|
DC6|DrugCostCompSched Seq|
DC7|DUR Conflict Code Lst|
DC8|DUR Conflict CdLstDtl|
DCA|Diagnosis Code Addtl|
DCC|Drug Coupon Common|
DCD|Drug Coverage Sts Dtl|
DCE|Data Collect Engines|
DCL|DEA Class List|
DCP|DUR/PPS Program CPT|
DCR|Disease Cross Ref|
DCS|Drug Coverage Sts Sch|
DCT|Default CPP TrOOP Amt|
DCW|Data Collection Work|
DCX|DataColl TranRange Wk|
DDA|Medicare DDC Mbr Audt|
DDB|Medicare DDC Plans|
DDC|Drug Dosage Check|
DDE|Ded Sch Dtl Ext|
DDI|DDID Drug Name|
DDL|DDI-DTMS Override Lst|
DDM|Medicare DDC Members|
DDN|DDI-DTMS Ovr Dtl Note|
DDO|DDI-DTMS Ovr Lst Dtl|
DDP|Medicare DDC Profile|
DDR|DDC TA Reconciliation|
DDT|DDC TA Corrections|
DDW|DDI-DTMS Ovr Dtl Wrk|
DE1|DEERS ELG CACHE TIME|
DEA|Class Product Table|
DED|DEA Class List Detail|
DER|DEERS Inq Trans Log|
DES|DESI Indicator Code|
DF1|Dosage Form|
DF2|Dosage Form Narrative|
DF3|UOM/Dosage Form PartD|
DFL|Dosage Form List|
DG3|DGO CT Adtl Override|
DGD|DUR GPI Detail|
DGL|Diagnosis List|
DGN|DUR Ovrrd Dtl Note|
DGO|DPA GPI Options Dtl|
DGP|DPA GPI Price Dtl|
DGQ|DynPA GPI Pre-Qual CT|
DGR|DPA GPI Rfl Too Soon|
DGT|Diagnosis List Table|
DGX|DPA GPI PA/MC Overid|
DGZ|Dyn PA GPI Fills Hist|
DID|DINFERRD Override Dtl|
DIG|Diagnosis|
DIL|DINFERRD Override Lst|
DIO|DINFERRD Ovr Dtl Note|
DIV|Division Assignment|
DKP|Dynamic PA Kit Prof|
DLD|Dosage Form List Dtl|
DLH|Drug App ID Link Hist|
DMC|Drug Mktg Category|
DMH|Drug Appl ID Mfr Hist|
DMM|Differential Min/Max|
DMP|DMR Payee Selection|
DMR|Direct Mbr Reimb Trak|
DN4|DNO CT Adtl Override|
DNO|DPA NDC Options Dtl|
DNP|DPA NDC Price Dtl|
DNQ|DynPA NDC Pre-Qual CT|
DNR|DPA NDC rfl Too Soon|
DNT|Duplicate Ntwk Work|
DNX|DPA NDC PA/MC Overid|
DNZ|Dyn PA NDC Fills Hist|
DOC|Addl Documentation|
DOD|DUR/PPS Override Dtl|
DOL|DUR Override Lst|
DON|DUR/PPS Serv Ovr Note|
DOO|DUR/PPS Serv Ovr Note|
DOP|DUR Override Percent|
DOQ|Addl Doc Qst Nbr/Ltr|
DP1|Dyn Prior Auth Usage|
DP2|Dyn PA Usage Profile|
DP3|Discount Pat Pay Tbl|
DPA|Dynamic Prior Auth|
DPD|Dynamic PA Desc|
DPG|DUR/PPS Program|
DPH|DUR/PPS Program Pharm|
DPL|Dynamic PA List|
DPN|Dyn PA Usg Prof Notes|
DPO|DUR Override Percent|
DPP|Dyn PA Plan Overrides|
DPR|Dyn PA RxBFrmMgtSrvOv|
DPS|DUR/PPS Segment|
DPT|DUR/PPS Services Dtl|
DPU|Dyn PA DUR Overrides|
DPV|DUR/PPS Services|
DPW|Dup Patient Workfile|
DPX|DUR/PPS PHA Pharm Wrk|
DQC|Data Queue|
DRD|DUR Response Data|
DRE|DUR Response Data Ext|
DRM|PartD Reject Messages|
DRN|DUR Parm Table Note|
DRS|DeActiv Resubmit Clms|
DRU|MediHist DRU Segmnt|
DS1|Drug Status List|
DS2|Drug Status List Dtl|
DSC|Deductible Sch Ctrl|
DSD|Deductible Sch Dtl|
DSH|Drug App ID Summ Hist|
DSM|Daily Summary File|
DSN|Deduct Sch Ctl Notes|
DSO|DUR/PPS Serv Ovrride|
DSP|Days Supply Price Ovr|
DT2|Drug Therapy GPI|
DTC|Drug Therapy Class|
DTD|Drug Status Details|
DTF|Data Transformation|
DTL|DUPTHER Override Lst|
DTN|DUPTHER Ovr Dtl Note|
DTO|DUPTHER Ovr Lst Dtl|
DTQ|Database Queue|
DTT|Drug Status Table|
DTW|DUPTHER Ovr Dtl Wrk|
DTX|Dscnt Pat Pay Tbl Ext|
DU2|DTMS Exceptions|
DUG|Drug Use Review Group|
DUN|Drug Use Review Note|\
DUP|DupTherapy GPI Table|
DUR|Ingredient Table|
DUT|Edit Types|
DUW|Discount Pat Pay-Wrkf|
DV2|DUR/PPS Srv Dtl Notes|
DVL|DEA Validation List|
DVN|DUR/PPS Service Notes|
DVT|DEA ValidationListTbl|
DWN|Downtime Log File|
E12|E1T AddlDocumentation|
E13|E1T AddlDocQstNbr/Ltr|
E1T|E1 Transaction|
E1W|E1 Transaction Work|
E4U|PartD Ext Chg Trackng|
EBC|EOB to Client Profile|
EBD|EOB Denial Codes|
EBP|EOB Paid Codes|
EBR|EOB to Client Rej Cde|
ECI|Extracted Comp Ingred|
ECN|Elig Completed Notes|
EFR|Exc Facilitator RmtSy|
EGD|Elig Group Defaults|
EHD|Elig Health Defaults|
EHP|e-prescrb Hist profil|
ELD|Email Dist List Dtl|
ELF|Exception Comm Log|
ELG|Eligibility Clarif Cd|
ELT|Email Distribution|
EMC|Mbr Oth Coverage Dflt|
EMD|Elig Member Defaults|
EMP|Member PartD Defaults|
EMR|Elig Mbrship Response|
ENC|Environment Control|
ENV|Payment Environment|
EO1|EOBR Profile Header|
EO2|EOBR Profile Details|
EOD|Elig Override Dflts|
EPA|e-prescrib Mbr Audit|
EPD|e-prescrib log Dtl|
EPF|Eligibility Profile|
EPH|e-prescribing SPI Hst|
EPI|e-prescribing SPI Dtl|
EPL|e-prescribing log|
EPO|ElgPlan Override Work|
EPP|e-prescribing Profile|
EPR|e-prescrb Router Ctl|
EPS|e-prescribing Stats|
EPV|e-prescribing Vendor|
EQD|Elig Queue Defaults|
ERC|Error Code|
ERD|Elig Request Detail|
ERL|Transaction Error Log|
ERM|Error Return Code|
ERR|Electronc Refill Req|
ERT|Elig Request Tracking|
ESF|EOB Suppress File|
ESN|Extended Days Supply|
ETS|e-Pres Tier Schedule|
ETT|e-Pres Tier Sch Tier|
EVD|Event Detail|
EVH|Event Header|
EWD|Elig W/C Defaults|
EWT|PB Engine Weight Tbl|
EX1|Extract_File RxClaim|
EX2|RxTRACK Extract_File|
EX3|Workers Comp Extract|
EX4|Medicare Part D Extr|
EX5|Formulary Mgmt Extr|
EX6|MedPart D N Trans Ext|
EX7|Historical Part D Ext|
EXA|Medicare Part D Archv|
EXC|Extract Counts|
EXI|Extract Index|
EXR|Extract Rerun|
FA1|Fam Mbr Accum Key-Wrk|
FAD|Alternative Drugs Dtl|
FAL|Alternative Drugs Lst|
FAP|File Desc *ACCPTH|
FAS|Facility Segment|
FBA|File Desc *BASATR|
FCB|Contingent Therapy|
FCD|Pln Copay/Frmlry Dtl|
FCL|Pln Copay/Formlry Lst|
FCR|FFP/CHP Pricing Rates|
FCT|FFP/CHP Rate Tables|
FD1|FDB Product-Repostory|
FD2|FDB Clinical Formultn|
FD3|FDB Ingrd List/Cd Rel|
FD4|FDB HIC Ingredients|
FD5|FDB DrugStrgthCmpnts|
FD6|FDB Dosage Form|
FD7|FDB Route of Admin|
FDR|File Data Base Rel|
FFD|File Field Desc|
FFS|Formlry Lst Frm Sched|
FG6|Preferred GPI Message|
FG7|PrFrmlry GPI Lst Note|
FG8|PrFrmlry GPI Dtl Note|
FGD|PrefFormulary GPI Dtl|
FGL|PrefFormulary GPI Lst|
FGX|PFRM GPI PA/MC Overid|
FI1|File Load Work File|
FI2|FIR Transaction Dtl|
FI3|FIR Message|
FI4|FIR Rejected Trans|
FI5|FIR Reject Occur Ind|
FID|File ID Information|
FIR|Financial Info Report|
FIW|File ID Work File|
FLT|Formulary Lst TierSch|
FMC|MgmtSer Schd Criteria|
FMF|Family Member Fields|
FML|Formulary Alt List|
FMN|Formulary Alt NDCs|
FMP|FormMgmtServ Profile|
FMS|Formulary MgmtService|
FN1|Frmlry Notice List|
FN2|Frmlry Notice Product|
FN3|Frmlry Notice Change|
FN4|Frmlry Notice Reason|
FN6|Preferred NDC Message|
FN7|PrFrmlry NDC Lst Note|
FN8|PrFrmlry NDC Dtl Note|
FN9|Frmly Notice Prd Dtl|
FND|PrefFormulary NDC Dtl|
FNL|PrefFormulary NDC Lst|
FNW|PFN Work File|
FPB|Formulary Part D List|
FPD|FDB Product Data|
FPE|FDB Product ETC|
FPL|Product Limits|
FPR|FDB Product Rebate|
FQP|Fill Qual Price Ovr|
FRJ|Field Reject Codes|
FRL|Restriction List|
FS1|Formulary Status List|
FS2|Formulary Sts Lst Sts|
FSA|FlexSpendAcc Req&Resp|
FSB|Specialty Drug List|
FSC|Fee Schedule|
FSH|Fee Schedule Header|
FSL|Formulary Select list|
FSN|Fee Schedule Notes|
FSS|Form Mgmt Srv Sched|
FSX|Fee Sched Header Ext|
FTC|FDB Therapeutic Class|
FTE|FDA Therapeu Equiv Cd|
FW1|Prod FDB Price Work|
FW2|Prod FDB GCN Work|
FW3|GENSeq FDB Price Work|
FW4|Work FDB Prod Rebate|
FX1|Sbm FIR Accum Months|
FXN|Sbm FIR Transaction|
GA0|GUI Sec Application|
GA1|GUI Sec Panel|
GA2|GUI Sec Object|
GA3|GUI Sec Role|
GA4|GUI Sec Role Pnl Prm|
GA5|GUI Sec Role Pnl Obj|
GA6|GUI Sec User|
GA8|GUI Sec User-Role|
GA9|GUI Sec Logical|
GAA|GUI Customer|
GAB|GUI Customer-App|
GAD|GUI Panel Type|
GAE|GUI User Status|
GAF|GUI Object Type|
GAG|GUI Status Reason|
GAH|GUI Panel Permission|
GAI|GUI Object Permission|
GAJ|GUI CAG Access List|
GAS|Group Accumulator Sch|
GBD|Grp Ben Cod List Dtl|
GBL|Grp Benefit Code List|
GCC|Grp Cnts by Care Fac|
GCD|GPI Conversion Detail|
GCG|GenericCost-Share Gap|
GCI|GPI Carrier Detail|
GCM|Group Counts by Month|
GCN|GCN Seq/GCN X-Ref|
GCO|GPI Carrier Override|
GCP|Grp Cnts by Provider|
GCS|GPI Conv Structure|
GCV|GPI Conversion Info|
GDX|Generic Drug Xref|
GEL|Group Eligibility|
GID|Group ID Card History|
GII|Generic ID|
GIM|Generic Ind Message|
GIN|Generic ID Notes|
GIT|Group ID Card Trigger|
GLD|Group List Detail|
GLN|Plan GPI List Notes|
GMD|GPI Multi-Ingred Dtl|
GMI|GPI Multi-Ingred List|
GMM|GDI Multi-Ing CmpMsg|
GNO|Group Notes|
GP1|GPI List|
GP2|GPI List Detail|
GP5|GPPC-5 Display|
GPL|GUI Particptng Client|
GPM|GPPC Master|
GPS|Group Price Schedule|
GPT|Group Pat Pay Table|
GRB|Group Renewal Benefit|
GRL|Group List|
GRP|Group|
GRW|Group Work|
GS0|GUI Sec Application|
GS1|GUI Sec Panel|
GS2|GUI Sec Panel Fields|
GS3|GUI Sec Role|
GS4|GUI Sec Role Pnl Prm|
GS5|GUI Sec Role Pnl Fld|
GS6|GUI Sec Row|
GS7|GUI Sec Group Prmsn|
GS8|GUI Sec Group Users|
GS9|GUI Sec Challenge Lst|
GSC|GUI Sec Challenges|
GSI|Group Schedule ID|
GSM|Generic Subs Msg Dtl|
GTM|Generic Text Message|
GWF|Group Weight Fields|
GXL|Grp X-Ref List|
GXR|Group Xref|
HAP|A/P Matrix|
HBM|HCPCS Billing Mapping|
HC1|Holiday Calendar|
HC2|Holiday Calendar Date|
HC3|HIC3 Sequence|
HCH|HCPCS Change History|
HCL|HICL Sequence|
HCN|HCPCS Notes|
HCP|HCPCS Master|
HCZ|Remote Client ZipFile|
HDC|Claim History File|
HDP|Hist Files Claim Xref|
HDS|History Files Seq Xrf|
HIC|3 Class Code List|
HID|3 Class Code List Det|
HMP|HCPCS Multi Pricing|
HPD|Held Payment Detail|
HPH|Held Payment Header|
HPI|Product ID HCPCS|
HPP|Product HCPCS|
HPS|Custom Elig Plan Xref|
HRD|Con Schedule Details|
HRN|Contibution Sch Notes|
HRS|Contribution Schedule|
HTC|HCIdea Taxonomy Code|
IAA|IntgrdBenSavAdj Archv|
IAH|IntgrdBenSavAdjArchvH|
IAL|IntgrdBenSav Adj Log|
IAR|IntgrdBenSav Adj Rtrn|
IAU|IntgrdBenSav Adj Updt|
ICD|ICD-9 Name|
ICG|Ind GPi Co-Treatment|
ICM|Med Cond-ICD-9 X-Ref|
ICT|Ind Co-Treatment Set|
ID2|ID Card Output 2|
ID4|ID Card Output 4|
ID5|ID Card Output 5|
ID6|ID Card Output 6|
ID7|ID Card Output 7|
ID8|ID Card Output 8|
ID9|ID Card Output 9|
IDA|ID Card Address|
IDC|ID Card Profile|
IDD|ID Card Detail|
IDE|ID Card Profile Ext|
IDH|ID Card Prof Ext Pg2|
IDL|ID Card Logo XRef|
IDM|ID Card Prof-MoreFlds|
IDN|ID Card Additional|
IDO|ID Card Output|
IDR|ID Crd New/Reiss Ovrd|
IDX|ID Card Exceptions|
IGP|GPI Drug Indication|
IGT|Indications GPI Text|
IID|Incident ID Card|
INC|Incident Product|
IND|Incident Diagnosis|
INM|Incident Member|
INN|Incident Mbr Notes|
INP|Incident Physician|
INR|Interface File|
IPO|Mbr Inc Dtl Pln Ovr|
IPV|In Process Validation|
ISA|Intgrtd Accm/SvngsAcc|
ISC|Incentive Schedule|
ISD|Incentive Sched Dtl|
ITH|Indications Text Hdr|
ITX|Indications Text|
KPN|Dynamic PA Kit Note|
LAC|LICS Adjustment Ctl|
LBC|LICS Ben vc Cal Year|
LBD|Lockbox Detail|
LBN|Lockbox Notes|
LBR|Lockbox Reason|
LBX|Lockbox File|
LIC|Low-Income Cost Share|
LID|Letter ID Information|
LIE|LICS Detail Extension|
LIM|Limited Distribution|
LMI|Last Member ID Used|
LNG|ISO Language|
LNK|Link Control File|
LOB|Facets Line of Bus|
LPD|List of Plans Detail|
LPL|List of Plans|
LSC|LICS Schedule Ctl|
LSD|LICS Schedule Dtl|
LSQ|List Qualifier|
LTC|Long Term Care|
LTD|Long Term Care Detail|
LTE|Long Term Care D.0|
LTF|Long Trm Care Dtl D.0|
LUM|Last Used Member Id|
LVL|Level of Service|
M2S|Medi Hist P2 Segment|
MA1|Mbr Accum Key-Wrk|
MA2|Mbr Accum History-Wrk|
MA3|Member Adj Workfile|
MAA|Member Alt Address|
MAD|Member Adjustment|
MAH|Mbr Accum History|
MAI|Member Alternate Ins|
MAJ|Mbr Pymt Adjustment|
MAT|Mbr Pymt Adj Template|
MAW|Mbr Adj Hist - Work|
MBC|Member Contact|
MBD|Mbr Ben/Ded Hist-Work|
MBL|Member List|
MBN|Membership Notes|
MBP|Mbr Elig Purge Work|
MBR|Member|
MBW|Member Work|
MBX|Group/Account XREF|
MC1|Medical Condition|
MC2|Medical Cond Name|
MC3|Medical Cond Class|
MCC|MAC List Cost History|
MCD|Mbr CMS Demographics|
MCF|Member Care Facility|
MCG|MPA Compound GPI|
MCL|MAC List|
MCN|MPA Compound NDC|
MCO|Member Copay Override|
MCP|MAC List Products|
MCR|Mbr Credit Card Info|
MCS|Medi Hist PVD PC Seg|
MCT|Manual Claim Count|
MCU|MAC List Update Hstry|
MCW|MAC List Cost Work|
MDA|Action Code|
MDB|MPD PDE Batch Header|
MDC|Medicaid Nbr Assgnmnt|
MDD|MPD PDE Details|
MDF|DDPS Edit Codes Dtl|
MDG|Medicaid/Medigap Info|
MDH|MPD PDE File Header|
MDI|Action Log|
MDJ|Edit Category|
MDK|Exclusion Code|
MDL|DDPS Edit Codes List|
MDM|CMS Reject Codes File|
MDN|MD Network|
MDO|Maint Drug Price Ovr|
MDP|MD Network Profile|
MDR|Claims on CMS PDE fil|
MDS|Max Days Supply/Qty|
MDU|Medispan Daily Update|
MDW|MDD PDE Detail Work|
MDX|Member Diagnosis Code|
MDY|PDE Detail Rejects|
MEA|Member EOB Address|
MEC|Mbr External Coverage|
MED|Medicaid Product Dtl|
MEI|Mbr Ext Alternate Ins|
MEL|Member Eligibility|
MEN|Mbr Eligibility Notes|
MEP|Mbr E-Prescribing|
MFG|Manufacturer|
MFL|Medi Hist Format List|
MFS|MediHist Format Segmt|
MFT|MBI FSA TransReq&Resp|
MG3|MGO CT Adtl Override|
MG8|MPA GPI Ben Max Hist|
MGD|PA GPI List Detail|
MGL|PA GPI List|
MGN|Message Note|
MGO|Mbr PA GPI OptionsDtl|
MGP|Mbr PA GPI Price Dtl|
MGQ|MbrPA GPI Pre-Qual CT|
MGR|MPA GPI Rfl Too Soon|
MGX|MbrPAGPI-PA/MC Overid|
MGZ|Mbr PA GPI Fills Hist|
MHD|Mbr Move Hist Detail|
MHF|Medi Hist Format|
MHH|Member History Header|
MHM|Mbr Move Hist Dtl Msg|
MHN|MAC Lst Cst Hist Note|
MHP|Member Health Profile|
MID|Member ID Card|
ML0|MAC List Notes|
ML1|Multi-Source List Dtl|
MLC|Member Language Code|
MLD|Member List Detail|
MLF|Medi Hist List-Format|
MLN|MAC Lst Prod Note|
MLW|Multi-Member List Wrk|
MLX|Mac List Ext|
MMA|Mbr Med D Audit|
MMC|Member Coverage|
MMD|Mbr Medicare Part D|
MMF|Medicaid Master File|
MMH|Member Move History|
MMI|Member Move Input|
MMP|Member Move Profile|
MMR|Member Move Request|
MMU|Manual Member Add/Chg|
MN4|MNO CT Adtl Override|
MN8|MPA NDC Ben Max Hist|
MND|PA NDC List Detail|
MNL|PA NDC List|
MNO|Mbr PA NDC OptionsDtl|
MNP|Mbr PA NDC Price Dtl|
MNQ|MbrPA NDC Pre-Qual CT|
MNR|MPA NDC Rfl Too Soon|
MNU|SXC Menu File|
MNX|MbrPANDC-PA/MC Overid|
MNZ|Mbr PA NDC Fills Hist|
MO2|Method of Payment Dtl|
MOD|Modifier|
MOM|Member Online Maint|
MON|Method of Pay Notes|
MOP|Method of Payment|
MP1|Pharm Network Prv Ovr|
MP2|Pharmacy Prv Ovr|
MP3|Prscriber Net Prv Ovr|
MPA|Member Prior Auth|
MPC|Mbr PA COB Ovr Detail|
MPD|MPA Audit History|
MPE|Medicare Prcssng Edts|
MPL|Msg Priority Sch Dtl|
MPN|Member PA Notes|
MPO|Mbr Provider Override|
MPP|Mbr PA Plan Overrides|
MPR|Mbr PA RxBFrmMgtSrvOv|
MPS|Msg Priority Schedule|
MPT|Mbr Provider Ovr Note|
MPU|MBR PA DUR Overrides|
MPW|Mbr Prov Ovr Workfile|
MRA|Member Reimb Address|
MRP|Mbr Reimb Phar Res|
MSA|MediHist Segment Audt|
MSC|Mbr Security for Clms|
MSD|MediHist Segment Dtl|
MSG|Message|
MSH|Multi-Src Tran Hdr|
MSI|Mbr Supplemental ID|
MSL|Multi-Source List|
MSN|Multi-Src Tran Notes|
MST|Multi-Src Tran Dtl|
MSW|Message Workfile|
MTM|Medication Ther Mgmt|
MTN|Member Termination|
MTR|Member Tracking|
MTX|Medictn Ther Mgmt Wrk|
MVC|Medicaid PrdView Cov|
MVL|Medicaid PrdView List|
MVO|Medicaid PrdView Prof|
MVP|Medicaid PrdView Prod|
MX2|Mbr Cross Reference 2|
MX3|Mbr XRef Lst W/DOB&PC|
MX4|Mbr XRef Dtl W/DOB&PC|
MXC|Mbr X-Ref Conv List|
MXL|Mbr X-Ref List|
MXM|Mbr X-Ref Conv Mbr ID|
MXP|Mbr X-Ref List Plus|
MXR|Mbr Cross Reference|
MXU|Mbr X-Ref Conv Update|
N10|NCP COB/OthPyrPatRspb|
N11|NCP COB/OthPyrBnftStg|
N12|NCP AddlDocumentation|
N13|NCP AddlDocQstNbr/Ltr|
N14|NCP Facility|
N15|NCP Medicaid/Medigap|
N16|NCP Narrative|
N17|NCP CompoundIngModfr|
N18|NCP ClarificationCode|
NAR|Narrative|
NC0|NCP Prior Auth Doc|
NC1|NCP COB/Other Payment|
NC2|NCP COB Paid Info|
NC3|NCP COB Reject Info|
NC4|NCP Clinical Info|
NC5|NCP Compound Info|
NC6|NCP Diagnosis Cde Inf|
NC7|NCP DUR/PPS Info|
NC8|NCP Other Amt Claimed|
NC9|NCP Prior Auth|
NCD|NCPDP 51 DMR|
NCP|NCPDP Ver 5 Rel 1|
ND1|NDC List|
ND2|NDC List Detail|
NGF|Req Grp Fields Notes|
NJC|NJ Medicaid Control|
NJD|NJ Medicaid Encounter|
NJE|NJ Medicaid Error Fil|
NJH|NJ Medicaid Header Fl|
NJX|NJ Medicaid Extract|
NL2|NCPDP Pharm Ld Work 2|
NLD|Phar Network List Dtl|
NLH|Phar Network List Hdr|
NLN|Plan NDC List Notes|
NLW|NCPDP Pharm Load Work|
NMD|NDC Multi-Ingred Dtl|
NMI|NDC Multi-Ingred List|
NMM|NDC Multi-Ing CmpMsg|
NPD|Ntwk Plan Merge Dtl|
NPH|Ntwk Plan Merge Hdr|
NPI|Next Patient ID|
NSD|Message Code Detail|
NSH|Mess Code Schedule|
NXT|NX Transaction|
OBL|Omnicare Batch Log|
OBP|OMC BIN/PCN Control|
OC1|Opt CompoundIngrModfr|
OCD|Opt Compound Info Dtl|
OCL|Oth Payer Rptg Cntrl|
OCO|Opt Compound Info|
OHE|OMC Header Exception|
OME|Opt Member Info|
OOR|OptOrigPrscrbdProdInf|
OPA|Opt Patient Info|
OPC|Out Pokt Max Sch Ctrl|
OPD|Out Pokt Max Sch Dtl|
OPH|Opt Pharmacy Info|
OPN|Out of Poket Sch Note|
OPO|OOP Process Order|
OPT|Other Payer Trans|
ORD|Override RL Detail|
ORL|Override RFL Too soon|
ORP|Opt Pharmacist Info|
P01|Plan Maint Template|
P02|Plan Maint Range|
P03|Plan Detail|
P04|Plan Member Elig|
P05|Plan Member Elig Ext|
P06|Plan Mbr Age Elig|
P07|Plan Member COB Dtl|
P08|Plan Member Medicare|
P09|Plan Member DPA|
P0B|Neg Bal Adj Batch Hdr|
P0P|Neg Bal Adj Payment|
P0S|Pymt Create Sbm Fee|
P0T|Threshold Pymt Review|
P10|Customer Location|
P11|Plan RX Network|
P12|Pln Rx Ntwk Orig/Reim|
P13|Pln Phar Ntwk NDC/GPI|
P14|Pln Phar NDC/GPI List|
P15|CMP Compounds|
P16|Pln Compound Mult-Ing|
P17|Plan NDC List Table|
P18|Plan GPI List Table|
P19|Max Days Supply/Qty|
P1N|Parent Org Notes|
P20|Days Supply Price Ovr|
P21|Plan PrefFormularyNDC|
P22|PlanPrfFrml NDCLstPrc|
P23|Plan PrefFormularyGPI|
P24|PlanPrfFrml GPILstPrc|
P25|PRF FORM PA/MC Overid|
P26|Pref/NonPref Validn|
P27|Plan RX Restrictions|
P28|Plan Price Sched Hist|
P29|Plan Proration|
P30|Plan Deductible Hist|
P31|Plan OOP History|
P32|Plan Ben Max History|
P33|Plan Lftm Ben Mx Hist|
P34|Plan Prscbr Networks|
P35|Plan Prscbr Ntwk Msg|
P36|Plan Maintenance|
P37|Maint Drug Price Ovr|
P38|Plan DEA Class|
P39|Plan DEA Price Ovr|
P3X|Patient Pay Sched Ext|
P40|Plan Refill Limits|
P41|Plan Rfl Lmts Addtl|
P42|Plan Rfl Lmts Fill Ql|
P43|Plan Rfl Lmts Prc Ovr|
P44|Plan OTC Exceptions|
P45|Plan 3rd Party Excep|
P46|Plan Route of Admin|
P47|Plan Dosage Form|
P48|Plan Packaging Excep|
P49|Plan FDA Therapeutic|
P4X|Pat Pay Sch Tbl Ext|
P50|Plan Brand/Generic|
P51|Therapeutic Category|
P52|Plan Service Fee|
P53|Pln Cmpnd DESI|
P54|Pln Cmpnd Medicaid|
P55|Pln Phar Ntwk Vldtn|
P56|Pln Prescriber Vldtn|
P57|Pln Prescriber Sanct|
P58|Pln Pharmacist Vldtn|
P59|Pln Long Term Care|
P60|Pln Long Term Car Dtl|
P61|Plan Clarification|
P62|Plan POS Rebate|
P63|Plan RxPrice Sched|
P64|Plan Amt Due Schedule|
P65|Pat Residence POS|
P66|Long Term Care D.0|
P67|Long Term Car Dtl D.0|
P68|Plan NDC List Usr Msg|
P69|Plan GPI List Usr Msg|
P71|Pln Prod Qualifier|
P72|PlanTB OverrideDetail|
P73|Plan 340B Qualifier|
P7X|Price Basis Sched Ext|
PA1|PA Reason Code List|
PA2|PA Reason Cd List Dtl|
PAA|Prior Auth Agent Code|
PAD|Pharmacy ID List Dtl|
PAL|Pharmacy ID List|
PAM|Prior Auth Mbr Holder|
PAN|Prscrbr Mult Loc Note|
PAP|Prior Auth Protocol|
PAQ|Prescriber Addr Qual|
PAR|PriorAuth Reason Code|
PAS|Payer Adj Sequencing|
PAT|Patient Alias|
PAU|Prod Change Audit|
PAW|Prod Audit Load Work|
PB1|Fin Institutions|
PB2|Fin Inst Accounts|
PB3|Fin Inst Acct Notes|
PB4|Fin Inst Notes|
PB5|Form Type|
PB6|EFT Account Profile|
PB7|Fin Inst Acct Payee|
PB8|EFT Reopen Profile|
PBA|PB Data Col ADE Ctl|
PBC|Payer Batch Control|
PBD|Plan Ben/Ded History|
PBE|Prescriber ID Lst Dtl|
PBG|Plan Brand Genrc Subs|
PBL|Prescriber ID List|
PBP|Pay/Bill Processing|
PBR|Payer Reproc Parms|
PBS|Product Batch Supprss|
PBT|Transaction|
PBV|Plan 340B Qualifier|
PBW|PBT Transaction Work|
PC1|Cycle Control|
PC2|Cycle Dates|
PC3|Cycle Notes|
PC4|Contract Pharm Netwrk|
PC5|Plan Calendar|
PC6|Plan Calendar Details|
PCA|Product/Carrier Acct|
PCC|Contract Notes|
PCD|Paid Clm Reversal Dtl|
PCF|Plan Care Facility|
PCH|Process Ctrl Header|
PCI|Product Carrier PID|
PCL|Calendar|
PCM|Prod ID Carrier Msg|
PCN|Calendar Notes|
PCO|Product Carr Override|
PCP|Contract Pharmacy|
PCR|Paid Claim Reversal|
PCT|Contract|
PCV|Prd Price Calc Values|
PCW|Product Cost Workfile|
PCX|Process Ctrl Detail|
PD1|Price Dtl Ext 1 Pst|
PD2|Price Dtl Ext 2|
PD3|Price Dtl Ext3Rbl OBS|
PD4|Price Dtl Ext 4|
PD5|Price Dtl Ext 5|
PD6|Price Dtl Ext 6 APP|
PD7|Savings Acct Pay Dtl|
PD8|Savings Acct|
PD9|Price Dtl Ext 9|
PDA|Payer Dyn Adj Profile|
PDB|Price Dtl Benft Stage|
PDC|Plan DEA Code|
PDD|Product List Detail|
PDE|Price Dtl Extension|
PDF|Plan Dosage Form|
PDL|Product List|
PDM|Paid Message|
PDO|Plan DEA Price Ovride|
PDP|Part D Master Profile|
PDR|Savings Acct RollOver|
PDT|Price Detail|
PDV|Plan DEA Validation|
PDW|Phar Network Dtl Work|
PDX|Plan DUP Rx|
PEE|Plan Extension|
PEP|Pharmacy ePrescribing|
PET|Plan Type|
PF1|Payor 835 Fmt 01 Opt|
PF2|Payer 835 Fmt 02 Opt|
PFG|Plan PrefFormularyGPI|
PFH|Presc Fill History|
PFI|Formulary Information|
PFN|Plan PrefFormularyNDC|
PFV|Pref/NonPref Validn|
PFX|PRF FORM PA/MC Overid|
PG3|PGO CT Adtl Override|
PG6|Plan GPI Message|
PG7|Plan GPI ContTher MSG|
PG8|Plan GPI Ben Max Hist|
PGA|Audit PGL File|
PGD|PlanPrfFrml GPILstPrc|
PGH|Product GPI History|
PGI|Product Generic ID|
PGJ|Plan GPI Medicare|
PGL|Plan GPI List|
PGM|Plan Global Message|
PGN|Plan GPI List Notes|
PGO|Plan GPI Options Dtl|
PGP|Plan GPI Price Dtl|
PGQ|Plan GPI Pre-Qual CT|
PGR|Plan GPI Rfl Too Soon|
PGT|Plan GPI List Table|
PGW|PGO Work File|
PGX|Plan GPI PA/MC Overid|
PGY|Plan GPI Specialty|
PGZ|Plan GPI Fills Hist|
PH1|Pharmacy Change Hist|
PH3|Pharmacy E-Mail|
PH4|Pharmacy Long County|
PH5|Phar Upd Suppression|
PH6|Pharmacy Notes|
PH7|Plan Holiday Calendar|
PH8|Plan Holiday Cal Dtls|
PH9|Pharmacy Extension|
PHA|Pharmacy|
PHC|Pharmacy Contract|
PHD|Pharmacy Network Dtl|
PHE|Pharmacy Extension|
PHG|Pharmacy Group|
PHI|Pharmacist ID|
PHL|Prescriber Mult Loctn|
PHM|Pharm Manual Date/Sts|
PHN|Pharmacy Network|
PHP|Pharmacy Payee Review|
PHR|Pharmacy Hours|
PHS|Supprs HCIdea LoadUpd|
PHT|Pharmacist|
PHU|Phar Suppress Update|
PHV|Plan Pharmacy Vldtn|
PHW|PHD Pharm Ntwrk Work|
PHX|PHA Pharmacy Work|
PHY|Prescriber|
PHZ|Prescriber Taxonomy|
PI1|Prescriber ID Work1|
PIA|Product ID Link Audit|
PIC|Product ID Change Hst|
PID|Product ID|
PIH|Product Inquiry Hdr|
PIL|Product ID Link|
PIM|Pharmacy Medicaid ID|
PIR|Product Inquiry Dtl|
PIW|Product ID Work File|
PJ1|Payment Adj Header|
PJ2|Payment Adj Detail|
PJH|Overage Sts History|
PJL|Payment Job List|
PJO|Recoupment Overage|
PJR|Adj Tran Recoup Hist|
PJT|Adj Transaction|
PJX|Payment Adj Bypassed|
PKD|Package Description|
PKL|Packaging List|
PL1|Packaging List Detail|
PL3|PPL Work File|
PL4|Prescriber Load Deflt|
PLA|Pharm Load Addtl Flds|
PLC|Product Load Control|
PLD|Pharm Netwk List Dtl|
PLE|Plan Extension|
PLG|Payment Job Log|
PLH|Product Load Ctl Hist|
PLI|Prod Load In-Process|
PLL|Pharmacy Network List|
PLM|Payer Recoup Limit|
PLN|Plan|
PLO|Plan Legend OTC|
PLQ|Plan Qualifier|
PLT|Prescriber Load Track|
PM1|Plan Member COB Dtl|
PM2|Plan Pre Min Reimb|
PM3|Pln NDC List Messages|
PM4|Pln GPI List Messages|
PMA|Plan Member Age Elig|
PMC|Paid Message Code|
PMD|Product Modifier|
PME|Plan Member Elig|
PMI|Plan Pre MsgID Header|
PML|Plan Member DPA Lists|
PMM|Plan Member Medicare|
PMN|Plan Maintenance|
PMP|Payer Member Payee|
PMR|Plan Post Min Reimb|
PMT|Prompt File|
PMX|Plan Member Elig Ext|
PN0|Pharmacy Rural Flag|
PN1|Phar Ntwk NDC/GPI Lst|
PN2|Network Reimbursement|
PN3|PHN Work File|
PN4|PNO CT Adtl Override|
PN5|Plan NDC List Notes|
PN6|Plan NDC Message|
PN7|Plan NDC ContTher MSG|
PN8|Plan NDC Ben Max Hist|
PNA|Audit PNL File|
PNB|Neg Bal Trans Audit|
PND|PlanPrfFrml NDCLstPrc|
PNE|Pharmacy Network Ext|
PNF|Plan Notes File|
PNJ|Plan NDC Medicare|
PNL|Plan NDC List|
PNN|Network Notes|
PNO|Plan NDC Options Dtl|
PNP|Plan NDC Price Dtl|
PNQ|Plan NDC Pre-Qual CT|
PNR|Plan Prscbr Ntwrk Ovr|
PNS|Plan NDC Rfl Too Soon|
PNT|Plan NDC List Table|
PNU|Pharm Activity Update|
PNV|PlanPharmacyNtwkVldtn|
PNW|PNO Work File|
PNX|Plan NDC PA/MC Overid|
PNY|Plan NDC Specialty|
PNZ|Plan NDC Fills Hist|
PO1|Payor|
PO2|Payer Clients|
PO3|Payer Dtl Payee OVR|
PO6|Payor Notes|
PO7|Payer Client Notes|
PO8|Payer Payee Ovr Notes|
POC|Plan Override Control|
POG|Parent Organization|
POH|Plan Override SchdHdr|
POL|Payer Carr Collection|
PON|Payor Payee Ovr Notes|
POO|Plan Override SchNote|
POP|Payor Payee Override|
POR|Pln Rx Ntwk Orig/Reim|
POS|Plan Override SchdStp|
POV|Plan Overrides|
PP1|Process|
PP2|Process Run Schedule|
PP3|Process History|
PP4|Process Hist Clm Cnt|
PP6|Process Notes|
PPA|Pymt Prof Adj Audit|
PPD|Pref Product List Dtl|
PPE|Plan Pre & Post Edits|
PPF|Plan Partial Fill|
PPG|Payor Profile Group|
PPH|Pay Prof Phar Network|
PPJ|Payment Prf AdjstList|
PPM|Payment Amt Profile|
PPO|Prod Avg Price Output|
PPP|Payer Pharmacy Flags|
PPR|Plan Post Accpt Reimb|
PPS|Payment Profile|
PPT|Plan Pre & Post Notes|
PPV|Plan Prescriber Vldtn|
PPW|Wk PymtProf Payee Lst|
PPX|Plan Prescriber Sanct|
PQ1|Provider ID Qual List|
PQ2|Prov ID Qual List Dtl|
PQD|Plan Qual List Detail|
PQL|Plan Qualifier List|
PQV|Prod Qualifier Vldtn|
PR1|Payment Purge Control|
PR2|Payment Purge History|
PR3|Payment Purge Rptg|
PR4|Payment Purge Archive|
PRB|Plan POS Rebate|
PRC|Price Schedule|
PRD|Product|
PRE|Prescription|
PRF|Prescriber ID|
PRG|Special Compile Prgms|
PRH|Product Change Hist|
PRI|Presc Instructions|
PRL|Pharmacy Relationship|
PRM|Paid Reversal Message|
PRN|Product Notes|
PRO|Processor|
PRP|Patient Residence POS|
PRQ|Prescriber Qual Type|
PRR|Plan RX Restrictions|
PRS|Prescriber Segment|
PRT|Plan Proration|
PRV|Provider Nbr Assignmt|
PRW|Product Work Load/Stg|
PRX|Plan RX Network|
PS1|Price Schedules|
PS2|Pat Pay Sch Clnt Lmts|
PS3|Patient Pay Schedule|
PS4|Patient Pay Sch Table|
PS5|Patient Pay Sch Note|
PS6|Rebill Patient PaySch|
PS7|Price Basis Schedule|
PS8|Price Basis Detail|
PS9|Price Basis Notes|
PSA|Plan Sched Amt Due|
PSB|Product Std Billing|
PSC|Price Sched Criteria|
PSD|Pref Prd Schd PPL Dtl|
PSF|Price Prof Srv Fee|
PSL|Pref Prod Schedule|
PSM|Plan Status Message|
PSP|Prescriber Specialty|
PSR|Prescriber Sanction|
PSS|Price Basis Step Dtl|
PST|PRD Step Therapy Grp|
PSV|Plan Pharmacist Vldtn|
PSW|PHA Specialty Work|
PSX|Price Schedule Ext|
PSY|P&B System Control|
PT1|Payee|
PT2|Payee Notes|
PT3|Payee Pharmacy|
PT4|Payee EFT Pre-Notify|
PT5|Payee List|
PT6|Payee List Detail|
PT7|Payee Extension|
PT8|Payee List Re-Validte|
PTD|Plan Test Clm Lst Dtl|
PTE|Plan Thearapy Excptn|
PTF|Pricing Table|
PTI|Prescription TFR In|
PTL|Plan Test Claim List|
PTN|Patient Pay Tbl Note|
PTO|Prescription TFR Out|
PTP|Plan 3rd Party Except|
PTR|Prescription Trigger|
PTT|Transaction Type|
PTV|Payee Pharm Re-Validt|
PTW|Pricing Table Wrk Fle|
PTX|Pharmacy Taxonomy|
PTY|Product Type|
PUC|Product Unit Cost|
PUD|Excps Unit Dose/Pckg|
PUO|Product Cost Override|
PUW|Prod Unit Cost Work|
PV1|Reopened Payment|
PV2|Reopened Payment Dtl|
PVW|Reopen Report Work|
PW1|Work PPS Payment Prof|
PW2|Work C/A/G Cash Req|
PW3|Work Carr Pymt Brkdn|
PW4|Work Pharm Totals|
PW5|Cash Req Output Fmt|
PW6|Payee/Adj Work File|
PW7|Payee/Carr Work Rpt|
PW8|Work Payment Summary|
PW9|Work Pymt Adj for 835|
PWA|Pymt Work Adj Rptg|
PWB|Work Neg Bal Trans|
PWC|Work Check Nbr Banner|
PWE|Payee Adj List WrkFil|
PWH|PBT Trans Held WrkFil|
PWJ|Wrk Pymnt Remit Dtl|
PWN|Wrk Payee Neg Amt Due|
PWR|Pymt Work Reissued|
PWS|Wrk Suppl Remit Advce|
PWT|Payment Work Xfr Adj|
PWV|Work Void/Reasgn Chks|
PX1|Plan X-Ref Header|
PX2|Plan X-Ref|
PX3|Plan X-Ref|
PX4|Plan X-Ref|
PXF|Plan Cross Reference|
PXH|Plan X-Ref Header|
PXR|Plan X-Ref|
PXS|Plan RxPrice Schedule|
PXT|Dyn Adj Trans X-Ref|
PY0|Pymt Batch Creation|
PY1|Payment|
PY2|Payment Detail|
PY3|Disbursements|
PY4|Check Detail|
PY5|Check Reconciliation|
PY6|Payment Denial Work|
PY7|EFT Register|
PY8|Payment Check Clear|
PYB|Payment Batch|
PYE|Pymt EOBR Detail|
PYF|Pymt Chk Fulfillment|
PYL|Pymt Mbr Collection|
PYM|Pymt Mbr Collect Send|
PYN|Prescriber Note|
PYP|Pymt Creation Payee|
PYR|Check Reg, fmt 2(New)|
PYS|Check Reg, format 9|
PYT|Check Reg File Fmt 08|
PYU|Check Reg Format 07|
PYV|Check Reg Format 06|
PYW|Check Reg Format 05|
PYX|Check Reg Format 04|
PYY|Check Reg, format 2|
PYZ|Check Reg Format 1|
QMF|Queue Monitor File|
QXT|Qualifier Xref Table|
R01|Plan Maint Result|
RAC|Route of Admin Lst Cd|
RAD|Route of Admin|
RAE|Rte Admn Excpt Detail|
RAL|Route of Admin List|
RAO|RxSupport ACMS Lst Ob|
RAP|Near RealTime Adj Prf|
RB1|POSRebateListCostNote|
RB2|POS Rebate List Note|
RBC|POS Rebate List Cost|
RBL|POS Rebate List|
RBN|POSRebateListProdNote|
RBP|POS Rebate List Prod|
RC1|Req Manual Claim Flds|
RC2|Req Claim Seg Flds|
RC3|Req Claim Notes Flds|
RC4|Req Claim Selection|
RC5|Reqd Claim Field Note|
RC6|Req Claim Submission|
RCD|Required Carrier Dtl|
RCF|Router Control File|
RCL|Reprocess Claim File|
RCM|Rejected Claim Msg|
RCN|Required CAR Dtl Note|
RCP|Rej Claim Plan Option|
RCR|Router Cntl Remapping|
RCZ|Remote Client ZipFile|
RD0|Req NCPDP D.x Fields|
RD2|Reproc Output Dtl2|
RD3|Reproc Output Dtl3|
RDC|Rgnl Disastr Criteria|
RDD|Rider List Detail|
RDL|Rider List|
RDN|Rgnl Dstr NDC/GPI Ovr|
RDO|Regional Disaster Ovr|
RDS|Refill/Days Limit|
RED|RDS Enrollee List Dtl|
REE|Reissued EFT as EFT|
REG|Region|
REJ|Reject Codes|
REL|RDS Enrollee List|
REN|Route Entity File|
REO|Remote Elig Override|
REP|Route Entity Pharmacy|
REQ|Required NCPDP Fields|
RET|Reopened EFT Trans|
RFL|Refill Limits|
RFS|Referral Status|
RGF|Required Group Fields|
RGN|Region Notes|
RH2|Reproc Output Hdr2|
RH3|Reproc Output Hdr3|
RIC|Reissued Check Tran|
RIF|Required Incident Fld|
RIM|Reject Interval Msg|
RIP|Reissue Check Profile|
RIS|Reject Interval Sched|
RJC|Rejected Claims|
RJE|Rej Cde Lst Codes|
RJL|Reject Code List|
RJN|Rejected NTransaction|
RJR|Rejected Reversals|
RKM|Risk Morbidity Grp|
RL1|QA Process Rule StrCm|
RLC|Resubmit Loc Codes|
RMA|Remote Medical Accum|
RMC|RxMG List Detail|
RMD|Retail & Mail Detail|
RMF|Required Member Field|
RML|RxMG List|
RMN|Required Mbr Fld Note|
RMP|Required MemPartD Dft|
RMS|RxSupport Mod SRs|
RMT|Retail & Mail Table|
RN5|Req NCPDP 5.X Fields|
RND|Notifict Table Detail|
RNL|Notification Tbl List|
RNM|Rejected NTran Msg|
RNS|Notificatn Stub File|
RNT|Notification Table|
ROD|Reproc Output Detail|
ROH|Reproc Output Header|
ROI|Reject Occurrence Ind|
RP1|RxPrice Schedule|
RP2|RxPrice Schedule Dtl|
RP3|RxPrice Schedule Note|
RPC|Reprocessed Claims|
RPD|ReasonCodeProfile Dtl|
RPE|ReasonCodeProfile Ext|
RPF|Required Profile Flds|
RPH|ReasonCodeProfile Hdr|
RPL|Rebill Price Limits|
RPM|RP Note Hdr|
RPN|RP Note Dtl|
RPO|Refill Lmts Price Ovr|
RPP|RP PA Plan Overrides|
RPQ|RP Note Ext|
RPR|RP PA RxBFrmMgtSrvOvr|
RPS|Rebill Price Schedule|
RPU|RP PA DUR Overrides|
RQN|Req NCPDP Flds Notes|
RR1|Reject Code Remap|
RR2|Reject Code Remap Tbl|
RR3|RejectCodeRemapTblDtl|
RRA|Reprocess Reimb Addr|
RRC|Reverse Reason code|
RRD|RX Restriction Sched|
RRE|Rx Rest Sched Detail|
RRL|Reverse Reason cdelst|
RRM|Rejected Reversal Msg|
RRN|Rx Rest Sched Note|
RS1|RxSupport SR File Obj|
RS2|RxSupport SR Prog Obj|
RS3|RxSupport SR Messages|
RS4|Residence/Service Dtl|
RSC|Ref Sts Schd Criteria|
RSD|Reprocess Sched Dtl|
RSF|RxSupport File Objs|
RSH|Reprocess Sched Hdr|
RSL|Residence/Service Lst|
RSM|RxSupport MOM List|
RSO|RxSupport MOM Lst Obj|
RSP|RxSupport Prog Objs|
RSS|Referral Status Sched|
RTI|Resubmit Table ID|
RTM|Routing Member|
RTR|Pharmacy X-Ref|
RUL|QA Process Rules|
RW1|Work Pref GPI List Ld|
RW2|Work Pref NDC List Ld|
RW3|Work Pref GPI Plan Ld|
RW4|Work Pref NDC Plan Ld|
RW5|Work Pref GPI List V2|
RW6|Work Pref NDC List V2|
RW7|Work Pref GPI List V3|
RW9|Work Pref NDC List V3|
RX1|Phar Ntwk NDC List|
RX2|Phar Ntwk GPI List|
RX3|Phar Ntwk NDC Detail|
RX4|Phar Ntwk GPI Detail|
RX5|Pln Phar Ntwk NDC/GPI|
RX6|Pln Phar NDC/GPI List|
RX7|PharNtwk NDC Prc Dtl|
RX8|PharNtwk GPI Prc Dtl|
RXN|Rx Number|
RXP|RxPortal Log file|
RXS|RxCLAIM Summary|
RY1|Phr Ntwk NDC Lst Note|
RY2|Phr Ntwk GPI Lst Note|
RY3|Phr Ntwk NDC Dtl Note|
RY4|Phr Ntwk GPI Dtl Note|
S01|Savings Account Sched|
S02|Savings Acct Subtype|
S03|Savings Acct Payment|
S04|Savings AcctBen Reqmt|
S05|Savings Acct Program|
S06|Savings Acct Prg Dtl|
S07|Savings Acct Profile|
S08|Savings Acct Adjustmt|
S09|Sav Acct Mbr Part|
S10|Sav Acct Mbr Ord Ovr|
S11|Sav Acct Mbr Ord Dtl|
S12|Sav Acct Mbr Suspend|
S13|Grp Savings Acct Part|
S14|Bank Request Method|
S15|Sav Acct Subtype List|
S16|Sav Acct Subtype Dtl|
S17|Ext SA Exit Rsp|
S18|Ext SA Exit Rsp Dtl|
SAC|SavingAcct Code Table|
SAD|SA Code Type/Text|
SAE|Savings Acct Extract|
SAL|Sbm Alteration Log|
SAP|Sbm Alteration Purge|
SBD|Std Brand Disc Detail|
SBS|Std Brand Disc Sched|
SCC|Software Cert Detail|
SCF|Sanction Code File|
SCL|Sftwr Vndr Cert list|
SCT|State Rate Table|
SDC|Segment Disp Cntl Fil|
SDT|SCHEDULD DOWNTIME CTL|
SE1|System Entity|
SE2|System Entity Appl|
SEC|Security|
SEE|Security Extension|
SEL|SvingAct ExtCall Log|
SEP|SvingAct ExtCall Parm|
SFA|Sbm Fee Applied|
SFC|Sbm Fee Appl by Carr|
SFD|Sbm Fee Dtl|
SFH|Prf Srv Fee Sched Hdr|
SFL|Prf Srv Fee Sched Dtl|
SFN|Prof Service Fee Note|
SFO|Prf Srv Fee SchedNote|
SFP|Sbm Fee Profile|
SFQ|Prof Service Fee Seq|
SFS|State Fee Schedule|
SFT|Prof Service Fee Tbl|
SFX|Prf Srv Fee Sch HdrEx|
SHS|Reprocessed Claims|
SLD|Specialty List Detail|
SLT|Specialty List Table|
SLW|SLD Specialty Work|
SM1|TCD Suspended Claims|
SMP|Sensitive Meds Profil|
SMR|Sens Med Product list|
SMT|Suspended Claim Trans|
SN1|Super Ntwk NDC/GPI|
SN2|Super Ntwk Reimburse|
SN5|SNtwk PNtwk NDC/GPI|
SND|Super Network Detail|
SNE|Super Network Ext|
SNH|Super Network Header|
SNN|Super Network Notes|
SNO|Specialty Notes|
SNP|Specialty Prog Notes|
SNX|Super Net Pharm Work|
SOR|Super Ntwk Orig/Reim|
SP1|SA Adj Prfl Pre-load|
SP2|Savings Acct Adj Prfl|
SP3|State PrcDisp Fee Dtl|
SP4|State PrcProf Fee Dtl|
SPD|State Pricing Tbl Dtl|
SPG|Specialty Program|
SPL|Specialty Profile Dtl|
SPN|Sbm Fee Profile Notes|
SPO|SPecialty Sched Notes|
SPP|Spclty Pharm Network|
SPQ|Specialty Program Seq|
SPR|Spclty Prescrib Ntwrk|
SPS|Specialty Schedule|
SPT|State Pricing Table|
SPX|Sanction Prescriber|
SSC|Sbm Fee Schedule|
SSD|Sbm Fee Sched Dtl|
SSN|Sbm Fee Sched Notes|
SSS|Sys Security Sector|
STA|State|
STD|State List Detail|
STG|Step Therapy Group|
STL|State List|
STP|State/Province|
STW|Work CndVal to State|
STX|Prf Srvc Fee Tbl Ext|
SUM|Summary File|
SW7|Sav Acct Profile Work|
SW8|SA Adjustment Work|
SYS|System Default|
T10|TCD Additional Info|
T11|TCD Med D Eligibility|
TAD|TransAdditionalDetail|
TAP|Trans Assoc Prescript|
TAX|Tax Schedule|
TBB|TB Batch Log|
TBI|Trans Ben OvrScd Item|
TBL|Vendor TB Letter Hist|
TBM|TB Letter Edit Codes|
TBO|Transitional Ben Ovrd|
TBR|Transisional Ben Rej|
TBS|Trans Ben Ovrd Schde|
TBW|TBL TB Letter Work|
TC2|Trans Common Dtl Ext2|
TC3|Trans Common Dtl Ext3|
TC4|Trans Common Dtl Ext4|
TC5|TCD Ext5-Plan Accums|
TC6|TCD Ext6-NDC/GPI List|
TC7|TrOOP/DS Coverage Lvl|
TC8|Additional CLM Amends|
TC9|TCD AddlClarificatnCd|
TCB|Trans CommonDetailRxB|
TCD|Trans Common Detail|
TCE|Trans Common Dtl Ext|
TCN|Trx Control Note|
TCP|TCD Product Work|
TCR|Test Claim Results|
TCS|Trn Lnk to Servic CLM|
TEX|Plan Test Claim Info|
TFM|Timely Filing-Manual|
TFR|To Facilitator Routng|
TFT|Timely Filing-Termed|
TGI|$G Drug Inquiry|
TGR|$G Drug Info Rsp|
THI|$H Patient Hist Inq|
THR|$H Patient Hist Rsp|
THS|$H Patient Rx Data|
THT|CET Threshold Table|
TII|$I Rx Fill Hist Inq|
TIR|$I Rx Fill Hist Rsp|
TIS|$I Refill Data Rsp|
TMD|TB Mess Code Sch Dtl|
TMH|TB Mess Code Sch Hdr|
TMI|$M Member Info Inq|
Tmp|Pharmacy Network Conv|
TMR|$M Member Info Rsp|
TMS|$M Coverage Data Rsp|
TOI|$O Transfer Out Inq|
TOT|Extract Ttls by CAG|
TPA|Trans Prior Auth|
TPC|TC4 Proratn Calc Vals|
TPD|Trans Prior Auth Doc|
TPP|Trans Pref Products|
TQI|$Q Prescriber Inquiry|
TQR|$Q Prescriber Respons|
TR2|Drug Coupon Lock|
TRA|Trans Response Action|
TRC|Tax Rate Code Table|
TRI|TB RejMsgSuppressItms|
TRP|TrOOP Extension File|
TRR|Transaction Reply Rpt|
TRS|TB RejMsgSuppressScde|
TRX|Rx Trans Record|
TSC|TrOOP Schedule Ctl|
TSD|TrOOP Schedule Dtl|
TSM|TrOOP Step Message|
TTI|$T Transfer Info|
TTK|Transaction Tracking|
TTP|Total Trans Processed|
TTR|$T Transfer Info Rsp|
TTT|Tier Translation Tble|
U10|Panel Function/Option|
U11|Role Panel Func/Opt|
UDC|User Defined Columns|
UDM|User Defined Prescrbr|
UDP|User Defined Pharmacy|
UDT|User Defined Tables|
ULD|User List Detail|
ULH|User List Header|
UMD|Utilizing Mbrs by Dte|
URF|Utilization ReviewFee|
US1|User Security Profile|
US2|Panel|
US3|Panel Authority -OBS|
US4|Panel Field|
US5|Panel Field Auth-OBS|
US6|Role|
US7|Role Detail|
US8|User/Group Role|
US9|Role Panel Field Auth|
USD|USL Audit Detail|
USF|Field Security Load|
USH|USL Audit Header|
USL|User Security Load|
USM|Security by C/A/G/M|
USP|User-Space Data|
USR|User Programs|
UTL|User Table List|
UTM|Utilizing Members|
V20|NCPDP Pharmacy Format|
VCD|VA Code Description|
VCH|Voucher Clm Pymt Hist|
VHD|3rd Party Trans Log|
VHM|3rd Party Adj Master|
VLC|3rd Party Letter/Call|
VPR|Validation Pull Reqst|
VPX|3rd Party Pend Revrsl|
VRH|Voucher Request Hist|
VRJ|VA Reject Code Master|
VSR|Voucher Send Request|
VTL|RXVEW Transaction Log|
VTP|VT Med ID/NABP X-Ref|
VWA|Voucher Work Activity|
WBB|Worker Compens Block|
WC3|Workers Comp 3 Claim|
WCB|Workers Comp B Claim|
WCC|Workers Comp Claim|
WCL|Wrk RxB Cust/List Sel|
WCS|Work Prod Cost Supp|
WDL|Webservice DynPA Log|
WHP|Work Held Payment|
WPE|Wrk Pymt Crt Engine|
WPN|Work Pharm Ntwk Dtl|
WPO|Works Comp Plan O/R|
WPR|Wrk Pymt Crt Restart|
WRK|Work file|
WSH|Withhold Schedule|
WSN|Withhold Sched Notes|
WSP|Wrk Sbm Fee Pharmacy|
WSS|Withhold Sched Step|
WTL|RxWEB Transaction Log|
XEA|RxEXCHNG Elig Audit|
XED|RxEXCHANGE Elig Dtl|
XEX|RxEXCHANGE Extract|
XFA|RxEXCHNG Forml Audit|
XMH|RxEXCHANGE Med Hist|
XNC|RxNorm Ext Source|
XND|RxNorm Variance ID|
XNR|RxNorm Relationship|
XNT|RxNorm Ext Src Text|
XNV|RxNorm X-Ref Variance|
XNX|RxNorm Ext Src X-Ref|
XTP|External Payment|
XTR|External Transaction|
XTS|External Tran Key|
Y2V|Extracted Conditions|
Y2W|Subordinate Fields|
ZPD|Zip Code List Detail|
ZPL|Zip Code List|
CK4A|DMR Check File|
CSTW|Commuication Sts Wrk|
D13D|THERDOSE Overide DTL|
D13L|THERDOSE Overide Lst|
D13N|DUR Overide Dtl Note|
ID10|ID Card Output 10|
ID11|ID Card Output 11|
ID12|ID Card Output 12|
ID13|ID Card Output 13|
ID14|ID Card Output 14|
ID15|ID Card Output 15|
ID16|ID Card Output 16|
ID17|ID Card Output 17|
ID18|ID Card Output 18|
ID20|ID Card Output 20|
ID3A|ID Card Output 3|
PRW2|Prod 2.5 Work Ld/Stg|
RW10|Wrk Pref GPI List V4|
RW11|Wrk Pref NDC List V4|
zA13|NCPDP Affiliation|
zCPM|Call Priority Maint|
zCQW|Call Track/Queue OBS|
zDGC|DPA ContingentTheOBS|
zDNC|DPA NDC Conting TOBS|
zGA7|GUI Sec Challenge Ls|
zGAC|GUI Sec Challenges|
zMGC|MPA ContingentTheOBS|
zMMP|Mbr Coverage Profile|
zMNC|MPA NDC Conting TOBS|
zNLA|NCPDP Affiliation|
zNLC|NCPDP Payment Center|
zNLP|NCPDP Pharmacy|
zP13|NCPDP Payment Center|
zPAB|Adjustment Batch|
zPAH|Adjustment|
zPCS|Product Carr/State|
zPGC|PlanContingentTheOBS|
zPH2|Pharmacy ReimbursOBS|
zPL2|Plan Ext2|
zPNC|PLN NDC Conting TOBS|
zPO5|Payor Dtl Pay Dt OVR|
zPO9|Payor's Pay Date Nte|
zPY9|Payment Profiles Usd|
zR13|NCPDP Pharmacy|
zRCF|Router Control File|
zRCR|Router Cntl Remappin|
AUAAI|Auto Assign Item|
AUAAS|Auto Assign Sched|
AUADI|Auth Default Item|
AUADN|Addl Drug Names|
AUAEI|Addl Extract Info|
AUALD|Alternate Drug|
AUALI|Alt Language Item|
AUALP|Alternate Drug Prod|
AUALR|Alt Drug List Rqst|
AUALS|Alternate Drug Schd|
AUAPR|RxAUTH Approval Typ|
AUAPT|Approval Trial Schd|
AUARD|AA RefusalReasonDta|
AUARR|AutoAsgn Rej Reason|
AUATP|Attachmt Sched Prod|
AUATS|Attachment Schedule|
AUATY|RxAUTH AuthType Tbl|
AUAU1|RxAuth Audit MstFil|
AUAU2|RxAuth Audit MstFld|
AUAUR|RxAUTH Request|
AUBAT|RxAUTH Prompt File|
AUBCT|RxAUTH BypContTher|
AUCCD|Client Contact Dtl|
AUCDQ|Client Default Ques|
AUCDS|Client Default Schd|
AUCLF|C/A/G List|
AUCLI|C/A/G List Item|
AUCNR|RxAUTH Cancel Type|
AUCPI|Custom Product Item|
AUCPL|Custom Product List|
AUCPR|Compound PRD Info|
AUCRF|RxAUTH Clinical Rev|
AUDBT|Database Trigger Cl|
AUDCH|RxAUTH Drug Cst Hdr|
AUDCS|RxAUTH Drug Cst Sav|
AUDMT|RxAUTH Doc Mgmt Trn|
AUDNR|RxAUTH Deny Type|
AUDOC|RxAUTH Document|
AUDOD|Document Detail|
AUEQX|RxAUTH Err/Que X-Rf|
AUERR|RxAUTH Error Code|
AUERS|Existing Reqst Schd|
AUETQ|RxAUTH ExamTyp Ques|
AUGNA|RxAUTH GenAttmptTbl|
AUINN|Insert ID Notes|
AUINR|Inactivate Type|
AUINS|RxAUTH Insert ID|
AULIQ|RXAUTH Ltr ID Quali|
AULQN|LtrID Qual ID Notes|
AULTR|RxAUTH Letter|
AUMAP|RxAUTH Manual Appro|
AUMDY|RxAUTH Manual Deny|
AUMNO|RxAUTH Menu Option|
AUMNU|RxAUTH Menu|
AUMPA|RxAUTH Mult Pmt Ans|
AUMUP|Multiple PAs|
AUMVC|Medicare Verbal Com|
AUORG|RxAUTH Origin Table|
AUPAD|RxAuth Prior SchDtl|
AUPAF|RxAuth PrtSchdI ADF|
AUPAO|RxAUTH Accum Ovrd|
AUPAP|RxAuth Prior SchPrd|
AUPAR|PA Sch Ovrrde-Rules|
AUPAS|RxAuth Prior Sched|
AUPAV|PA Sch Prd Override|
AUPCN|RxAUTH PrcCnflctTbl|
AUPCO|Prescriber Cntct Ov|
AUPFI|RxAUTH Profile Item|
AUPFL|RxAUTH Profile|
AUPGE|Prot Grp Expression|
AUPGI|Prot Grp Exp Item|
AUPIR|Protocol Item Rules|
AUPMT|RxAUTH Prompt Sched|
AUPNR|RxAUTH PndReasonTbl|
AUPOI|Prescriber Ovr Item|
AUPON|Prescriber Ovr Note|
AUPPI|Product Profile Itm|
AUPPO|RxAUTH Price Ovrd|
AUPRF|PA RxBFrmMgmtSrvOvd|
AUPRI|RxAUTH PrtSchd Item|
AUPRN|Print Vendor Notes|
AUPRQ|Protocol Questions|
AUPRS|RxAUTH Protocol Sch|
AUPRV|Print Vendor|
AUPSL|Protocl Summary Log|
AUPSS|Protocol Summry Sch|
AUPSV|RxAUTH PmtSch Value|
AUQLD|RxAUTH Queue LstDtl|
AUQSC|RxAUTH Queue Sched|
AUQSL|RxAuth Queue List|
AUQUR|RxAUTH Open/AsgnReq|
AURAF|RxAuth Request ADF|
AURAI|Role Authority Item|
AURAP|Role Auth Profile|
AURCI|RxAUTH Rej Cd Item|
AURCN|Recipient Contact|
AURCO|Recipient Cntct Ovr|
AURCS|RxAUTH Rej Cd Sched|
AURDD|Wrk Request Doc Dtl|
AURDH|Wrk Request Doc HT|
AURER|Request Error|
AURES|RxAUTH Reason Sched|
AURFF|RxAUTH Rfl/Fill Lim|
AURFL|RxAUTH RefillLimits|
AURGR|RxAUTH Req Glbl Res|
AURNT|RxAUTH Rqst Notes|
AURQR|RxAUTH Requestr Tbl|
AURQT|RxAUTH Req Type Tbl|
AURRA|Rqst Rqmt Addl Info|
AURRG|Req Rqm Grp/Sgm Sts|
AURRR|RxAUTH Rqst Rqmt|
AURRS|Req Rqm Grp Exp Sts|
AURSA|Reason Schd Alt Lng|
AURSC|RxAUTH Require Schd|
AURSH|RxAUTH BndGen OvrHs|
AURSP|RxAUTH RqSchProduct|
AURXT|RxAUTH Extract|
AUSDD|RxAUTH DtlSchDtlO/R|
AUSDO|RxAUTH Schd DUR O/R|
AUSIG|Signature Schedule|
AUSIR|Signature/Request|
AUSPO|RxAUTH Schd PA O/R|
AUSRD|Sbm Request Data|
AUSTS|RxAUTH Status Table|
AUTPD|RxAUTH TrialProfile|
AUTPS|RxAUTH TemplateSchd|
AUTRC|Trial Claim Summary|
AUTRL|Trial Summary|
AUTRS|RxAUTH Tmp Req Schd|
AUTSH|Trial Schedule|
AUTSI|RxAUTH TmpReqSchItm|
AUTTL|RxAUTH Title Table|
AUUCD|Urg Calendar Dtl|
AUUCS|Urg Calendar Sched|
AUUIM|Urgency Item|
AUUIP|Urgency Process|
AUUIR|Urgency Redirect|
AUULD|RxAuth User Lst Det|
AUUPD|Urgency Proc Dtl|
AUUPH|Urgency Proc Hdr|
AUUSL|RxAUTH User List|
AUUSR|RxAUTH User|
AUWCD|Web Confirm Details|
AUWFL|RxAUTH W Flows|
AUWIA|Web Intfce Addl Dtl|
AUWID|Web Interface Dupe|
AUWIP|Web Interface Prtcl|
HTCAG|HTH CAG Xref|
HTGRP|HTH Group/Plan Over|
NCPDP|Trans Record Member|
PBVCD|Voucher Claim Dtl|
R0DIR|Directory Mgmt|
R0ENV|Environment Backups|
R0FIL|Environment Files|
R0LCK|Environment Lock|
R0LIB|*LIBL Management|
R0LOG|Parallel Exec Log|
R0PEL|Parallel EnvLibrary|
R0RXD|Menu Detail|
R0RXM|Menu Header|
R0WR2|ROLOG WORK FILE|
R0WR3|R0DIR WORK FILE|
R0WRK|R0LIB WORK FILE|
RAADJ|Amount Adjustment|
RAALO|Alt Lang Override|
RAANA|Analysis Schedule|
RAAPC|RxACT Purge Control|
RAAPH|RxAct Purge History|
RAAPR|RxAct Purge Report|
RAASN|Anal Sched Note|
RAATL|IntrAct TransLifetm|
RACAT|Claim Assoc Trans|
RACER|Config Error|
RACIN|Comm ID Qual Note|
RACIQ|Comm ID Qualifier|
RACMF|Comm Fields|
RACMP|Compliance Schedule|
RACOM|Communication ID|
RACPF|Config PFL|
RACSN|Comp Sched Note|
RADMT|Document Mgmt Txn|
RADQ1|DB Queue Intervntn|
RADQL|DQ1 Lock File|
RAECL|Error Cde List|
RAECQ|Error Corr Queues|
RAEPN|Exclusion Prf Note|
RAEQX|RxACT Err/Que X-Ref|
RAERR|Error Code|
RAEXP|Exclusion Profile|
RAEXT|RxACT TSV Extract|
RAGAW|Gen Array Workfile|
RAHST|Historical Schedule|
RAIID|Insert ID|
RAIIN|Insert ID Note|
RAINV|Invalid Address|
RAIQI|Insert Comm ID Qual|
RAMHS|Mbr Health Schedule|
RAPCO|Prescriber Cntct Ov|
RAPFN|Participnt Prf Note|
RAPOI|Prescriber Ovr Item|
RAPON|Prescriber Ovr Note|
RAPPF|Participant Profile|
RAPPL|Products in Prd Lst|
RAPRL|Product List|
RAPSL|Products in SVC Lst|
RAQSC|Queue Schedule|
RAQSD|Queue Schedule Deta|
RAQSL|Queue Schedule List|
RARAC|RxACT Profile|
RARCD|Reject Code Lst Dtl|
RARCL|Reject Code List|
RARCN|Recipient Contact|
RARCO|Recipient Cntct Ovr|
RARDF|Reprcs Drv File|
RARPN|RxACT Prf Note|
RARRL|Reason List Detail|
RARSK|Risk Scores|
RARSL|Reason List|
RARSN|Reason|
RASBM|Submitted Schedule|
RASCN|Schdule Prf Note|
RASLC|Service List Crit|
RASLN|Service List Note|
RASPF|Schedule Profile|
RASPI|Sched Profile Item|
RASPN|Service Prf Note|
RASTS|RxACT Status Table|
RASVL|Service List|
RASVP|Services Profile|
RATER|Transaction Error|
RATND|TB Rej Reason Dtl|
RATNL|TB Rej Reason List|
RATNT|Transaction Note|
RATPP|Threshold Prot Prof|
RATPS|Template Schedule|
RATRH|Threshold Profile|
RATRL|Trial Schedule|
RATSV|Transaction Service|
RATTR|Trial Transaction|
RATXN|RxACT Transaction|
RAULD|RxACT User Lst Det|
RAUSL|RxACT User List|
RAUSR|RxACT User|
RAWDP|Work Document Print|
RCRKW|Event Trigger file|
RKRCB|Rx Cost Band Detail|
RKRCS|Rx Cost Band Sched|
RKRKP|Risk Prediction Prf|
RKRMG|RxMG Code List|
RKRRS|Rx Risk Score|
RKRRT|Rx Risk Score Codes|
RLCAG|Base CAGM Keys|
RLFLD|File Fields|
RLFLW|Fields Work File|
RLMBL|Member Profile|
RLMLD|Member List Detail|
RLMLM|Member List Header|
RLMMT|Member Mast Tag Lst|
RLPCC|Parallel Comm Ctrl|
RLPCL|Parallel Comm Log|
RLPCS|Parallel Clm Subs P|
RLPDS|Parallel DataSet Ct|
RLPPC|Proc Parameter Cntl|
RLPRO|Report Profile|
RLRCF|RCF Work File|
RLRPH|Comparison Header|
RLRPT|Comparison Trans|
RLRPU|Comparison TransSum|
RLTCB|Claim Subset Fields|
RLTCD|Parallel Clms Keys|
RLTCK|Base TCD Keys|
RLVER|Report Profile Ver|
RLXFD|Excluded Fields Lst|
RLXFR|Excluded Fields Rec|
RQCPF|Client Profile|
RQCSD|Client Select Desc|
RQCSF|Client Setup|
RQCTL|SXC Control|
RQCTP|Constraint Type|
RQDDS|QA Database Desc|
RQHIS|Refresh/Restore His|
RQSDF|System Definition|
RQSFD|Select Field Desc|
TMDSE|Disease State Codes|
TMDSR|Disease State Rules|
TMDSS|Disease State Sched|
TMMDZ|Mbr Disease States|
TMMGW|PGO Work File|
TMMTC|Disease State Claim|
TMMTD|Med Ther List Dtl|
TMMTE|Mbr MTM Pgm Elig|
TMMTL|Med Ther List|
TMMTP|Med Ther Profile|
TMTM1|Therapy Mgmt Prof|
TMTM2|Therapy Mgmt Claims|
WKNCP|Plan Test Claim Lst|
