TrOOP|True Out of Pocket Expense|
Troop|True Out of Pocket Expense|
Pln|Plan|
ADD|*Add|
CHG|*Change|
#|#|
%|%|
CODE|Code|
Crdhldr|Cardholder|
DAY|Day|
DateTime|Date/Time|
E-Mail|E-Mail|
Email|E-Mail|
Formulary|Formulary|
Innovator|Innovator|
Max|Maximum|
NDC|NDC|
OF|of|
Overage|Overage|
PAY|Payment|
Payee|Payee|
Pay|Pay|
Pos|Positive|
Prescriber|Prescriber|
Proration|Proration|
RX|Rx|
Recoupment|Recoupment|
Refund|Refund|
Requestor|Requestor|
Rx|Rx|
Submitter|Submitter|
Txn|Transaction|
Vaccination|Vaccination|
ZIP|ZIP|
Zip|ZIP|
999s|999s|
Accum|Accumulated|
Alt|Alternative|
App|Approved|
COB|COB|
Cd|Code|
DEA|DEA|
Depndnt|Dependent|
Due|Due|
GPI|Generic Product Identifier|
ID2|Identifier 2|
ID3|Identifier 3|
ID4|Identifier 4|
ID5|Identifier 5|
Labeler|Labeler|
O/R|Override|
Ovr|Override|
PA|Prior Authorization|
Pat|Patient|
Pharm|Pharmacy|
Rbl|Rebill|
Val|Values|
$|$|
*JOB|*Job|
*PROGRAM|*Program|
*TIME|*Time|
*USER|*User|
-|-|
/|/|
A/N|Alpha/Numeric|
Acct|Account|
Adj|Adjucation|
Amt|Amount|
Auth|Authorized|
Ben/Ded|Benefits/Deductions|
Ben|Benefit|
Cde|Code|
Clm|Claim|
Comp|Compensation|
Desc|Description|
Dte|Date|
Eff|Effective|
Ext|Extention|
Id|Identifier|
Ind|Indicator|
Lvl|Level|
MIN|Minimum|
Mbr|Member|
Min|Minimum|
Nbr|Number|
Nme|Name|
Oth|Other|
Ovrde|Override|
Ovrd|Override|
PROV|Provider|
Phar|Pharmacy|
Prc|Price|
Prov|Provider|
Pyr|Payor|
QTY|Quantity|
Qty|Quantity|
Qual|Qualifier|
Rec|Recent|
Req|Request|
Rsp|Response|
RxCLAIM|RxCLAIM|
SBM|Submitted|
SEQ|Sequence|
Sav|Savings|
Sbm|Submitted|
Sched|Schedule|
Seq#|Sequence Number|
Seq|Sequence|
Sts|Status|
THRU|Through|
Thru|Through|
id|Identifier|
lvl|Level|
nbr|Number|
seq|Sequence|
sts|Status|
Abbreviation|Abbreviation|
Absence|Absence|
Absolute|Absolute|
Abuse|Abuse|
Accept|Accept|
Acceptable|Acceptable|
Acceptance|Acceptance|
Accepted|Accepted|
Accepts|Accepts|
Access|Access|
accessed|Accessed|
Accessible?|Accessible?|
Accessible|Accessible|
Accident|Accident|
Account?|Account?|
Account|Account|
Accounting|Accounting|
Accumulated|Accumulated|
Accumulation|Accumulation|
Accumulator|Accumulator|
acquire|Acquire|
Action|Action|
Activate|Activate|
ACTIVATION|Activation|
Active|Active|
Activity|Activity|
Actual|Actual|
Acute|Acute|
Add|Add|
Added|Added|
Adding|Adding|
Additional|Additional|
Address|Address|
Addressee|Addressee|
Adjudicate|Adjudicate|
Adjust|Adjust|
Adjusted|Adjusted|
Adjuster|Adjuster|
adjustment|Adjustment|
Adjustment|Adjustment|
Adjustments|Adjustments|
Adjustor|Adjustor|
Administered|Administered|
Administration|Administration|
Administrative|Administrative|
Adverse|Adverse|
Advice|Advice|
Affect|Affect|
Affected|Affected|
Affiliation|Affiliation|
After|After|
Age|Age|
Aged|Aged|
Agency|Agency|
Agent|Agent|
Alcohol|Alcohol|
Alert|Alert|
Algorithm|Algorithm|
ALIAS|Alias|
Alias|Alias|
Aliasing|Aliasing|
All|All|
Allergies|Allergies|
Allergy|Allergy|
Allocated|Allocated|
Allocation|Allocation|
allow|Allow|
Allow|Allow|
Allowance|Allowance|
ALLOWED|Allowed|
Allowed|Allowed|
Alpha|Alpha|
Alter|Alter|
Alternate|Alternate|
Alternative|Alternative|
Always|Always|
Amend|Amend|
Amended|Amended|
AMOUNT|Amount|
Amount|Amount|
Amounts|Amounts|
Analysis|Analysis|
Ancillary|Ancillary|
and|and|
And|and|
Answer|Answer|
Any|Any|
Appeal|Appeal|
Append|Append|
Application|Application|
Applied|Applied|
apply|Apply|
Apply|Apply|
Approval|Approval|
Approve|Approve|
Approved|Approved|
Arch|Arch|
Archive|Archive|
Archived|Archived|
Area|Area|
Array|Array|
Arthritis|Arthritis|
as|as|
As|as|
Assign|Assign|
Assigned|Assigned|
Assignment|Assignment|
Assist|Assist|
Associated|Associated|
Asthma|Asthma|
at|at|
Attach|Attach|
Attachment|Attachment|
Attempt|Attempt|
Attempted|Attempted|
Attempts|Attempts|
Attention|Attention|
Attribute|Attribute|
Attributed|Attributed|
Audit|Audit|
Authority|Authority|
Authorization|Authorization|
Authorize|Authorize|
Authorized|Authorized|
Auto/Manual|Auto/Manual|
Auto|Auto|
Automate|Automate|
Automated|Automated|
Automation|Automation|
Auxiliary|Auxiliary|
Avail|Avail|
Availability|Availability|
Available|Available|
Average|Average|
Back|Back|
Backup|Backup|
Badge|Badge|
BALANCE|Balance|
Balance|Balance|
Band|Band|
Bank|Bank|
Base|Base|
Based|Based|
Basis|Basis|
Batch|Batch|
be|be|
Be|be|
Before|Before|
Begin|Begin|
Below|Below|
Benchmark|Benchmark|
Beneficiary|Beneficiary|
Benefit|Benefit|
Benefits|Benefits|
Between|Between|
Bill|Bill|
Billed|Billed|
Billing|Billing|
Bin|Bin|
Birth|Birth|
blank|Blank|
Blank|Blank|
Block|Block|
Blood|Blood|
Board|Board|
Body|Body|
Book|Book|
Boolean|Boolean|
Bound|Bound|
Branch|Branch|
Brand|Brand|
Break|Break|
Budget|Budget|
buffer|Buffer|
Build|Build|
Business|Business|
by|by|
By|by|
Bypass|Bypass|
Bypassed|Bypassed|
bytes|Bytes|
Cache|Cache|
Calculate|Calculate|
Calculated|Calculated|
Calculation|Calculation|
Calendar|Calendar|
Call|Call|
Cancel|Cancel|
Capacity|Capacity|
Caps|Caps|
Capture|Capture|
Captured|Captured|
Card|Card|
Cardholder/Spouse|Cardholder/Spouse|
Cardholder|Cardholder|
Cardholdr?|Cardholder?|
Cards|Cards|
Care|Care|
Carr|Carr|
Carrier?|Carrier?|
carrier|Carrier|
Carrier|Carrier|
Carry|Carry|
Case|Case|
Catastrophic|Catastrophic|
Category|Category|
Ceiling|Ceiling|
Census|Census|
Center|Center|
Central|Central|
CENTS|Cents|
Century|Century|
Certification|Certification|
Chain|Chain|
Challenge|Challenge|
CHANGE|Change|
Change|Change|
Changed|Changed|
changes|Changes|
Changing|Changing|
Char|Char|
character|Character|
Character|Character|
Charge|Charge|
Chars|Chars|
Check?|Check?|
CHECK|Check|
check|Check|
Check|Check|
Checking|Checking|
checks|Checks|
Checks|Checks|
Child|Child|
City|City|
CLAIM|Claim|
claim|Claim|
Claim|Claim|
Claims|Claims|
Clarification|Clarification|
CLass|Class|
Class|Class|
Classification|Classification|
Clear|Clear|
CLIENT|Client|
Client|Client|
CLinic|Clinic|
Clinic|Clinic|
Clinical|Clinical|
Close|Close|
Closed|Closed|
Closing|Closing|
Closure|Closure|
code|Code|
Code|Code|
Coded|Coded|
Codes|Codes|
Collate|Collate|
Collect|Collect|
Collection|Collection|
Color|Color|
Column|Column|
Comb|Comb|
Combination|Combination|
Combine|Combine|
Comment|Comment|
Comments|Comments|
Commitment|Commitment|
Common|Common|
Communication|Communication|
Company|Company|
Compare|Compare|
Comparison|Comparison|
Complete|Complete|
Completed|Completed|
Completion|Completion|
Compliance|Compliance|
Component|Component|
Compound|Compound|
Compounding|Compounding|
Compounds|Compounds|
Concept|Concept|
Condition|Condition|
Conditions|Conditions|
Confirm|Confirm|
Conflict|Conflict|
Conflicting|Conflicting|
Conflicts|Conflicts|
Congressional|Congressional|
Connection|Connection|
Consecutive|Consecutive|
Consent|Consent|
Consider|Consider|
Constraint|Constraint|
consumed|Consumed|
Contact|Contact|
Contacts|Contacts|
Contingent|Contingent|
Contract|Contract|
Contradiction|Contradiction|
Contribution|Contribution|
Control|Control|
Controlled|Controlled|
Conversion|Conversion|
Conversions|Conversions|
Convert|Convert|
Converted|Converted|
Copay/Benefit|Copay/Benefit|
Copay/Coinsurance|Copay/Coinsurance|
Copay/Co-insurance|Copay/Coinsurance|
Copay/Ded|Copay/Deductible|
Copay/Deductible|Copay/Deductible|
Copay|Copay|
CoPay|Copay|
copay|Copay|
Co-pay|Copay|
Copies|Copies|
Copy|Copy|
Copyright|Copyright|
Core|Core|
Corrected|Corrected|
Correction|Correction|
Correspondence|Correspondence|
Cost|Cost|
Cost-Sharing|Cost-Sharing|
Cost-Shrng|Cost-Sharing|
Count|Count|
Counter|Counter|
Country|Country|
Counts|Counts|
County|County|
Coupon|Coupon|
Cover|Cover|
Coverage|Coverage|
Covered|Covered|
CREATE|Create|
Create|Create|
Created|Created|
creation|Creation|
Creation|Creation|
Credit|Credit|
Creditable|Creditable|
Criteria|Criteria|
Cross|Cross|
Cryptic|Cryptic|
Cumulative|Cumulative|
Current|Current|
Currently|Currently|
Custom|Custom|
Customary|Customary|
Customer|Customer|
Cutoff|Cutoff|
Cycle|Cycle|
Cycles|Cycles|
Daily|Daily|
data|Data|
Data|Data|
Database|Database|
Date/Time|Date/Time|
DATE|Date|
date|Date|
Date|Date|
Dates|Dates|
Day|Day|
days|Days|
Days|Days|
Deactivate|Deactivate|
Death|Death|
Debit|Debit|
Decimal|Decimal|
Deduct|Deduct|
Deductible|Deductible|
Default|Default|
Defined|Defined|
Degree|Degree|
Delay|Delay|
DELETE|Delete|
Delete|Delete|
Deleted|Deleted|
Delivery|Delivery|
Demo|Demo|
DENIAL|Denial|
Denial|Denial|
Denied|Denied|
Deny|Deny|
Department|Department|
Depend|Depend|
dependencies|Dependencies|
Dependent|Dependent|
Dependents|Dependents|
Deposit|Deposit|
Depression|Depression|
described|Described|
DESCRIPTION|Description|
description|Description|
Description|Description|
Descriptor|Descriptor|
Desk|Desk|
Destination|Destination|
Detail|Detail|
Detected|Detected|
Deter|Deter|
Deviation|Deviation|
device|Device|
Device|Device|
devices|Devices|
Diabetes|Diabetes|
Diagnose|Diagnose|
Diagnoses|Diagnoses|
Diagnosis|Diagnosis|
Difference|Difference|
Differential|Differential|
Digit|Digit|
digits|Digits|
Digits|Digits|
Dimension|Dimension|
Direct|Direct|
Directions|Directions|
Director|Director|
Directory|Directory|
Disability|Disability|
Disaster|Disaster|
Disbursement|Disbursement|
Disc|Disc|
Disclaimer|Disclaimer|
Discontinue|Discontinue|
Discount|Discount|
Discretionary|Discretionary|
Discussion|Discussion|
Disease|Disease|
Dispense|Dispense|
Dispensed|Dispensed|
Dispenser|Dispenser|
Dispensing|Dispensing|
display|Display|
Display|Display|
Displayed|Displayed|
Disposition|Disposition|
Distribution|Distribution|
Division|Division|
Document|Document|
Documentation|Documentation|
Dollar|Dollar|
DOLLARS|Dollars|
Dosage|Dosage|
Dose|Dose|
Down|Down|
Drive|Drive|
Driver|Driver|
Drug|Drug|
Drugs|Drugs|
Dupe|Dupe|
Duplicate|Duplicate|
Duplication|Duplication|
Duplications|Duplications|
Durable|Durable|
Duration|Duration|
Dynamic|Dynamic|
Each|Each|
Earliest|Earliest|
Edit|Edit|
Effect|Effect|
Effective|Effective|
Effects|Effects|
Efficacy|Efficacy|
Effort|Effort|
Elapsed|Elapsed|
Election|Election|
Element|Element|
Eligibility|Eligibility|
Emergency|Emergency|
Employee|Employee|
Employer|Employer|
Enabled|Enabled|
Encounter|Encounter|
Encrypted|Encrypted|
Encryption|Encryption|
End|End|
Ending|Ending|
Engine|Engine|
Engines|Engines|
Enroll|Enroll|
Enrolled|Enrolled|
Enrollee|Enrollee|
Enrollment|Enrollment|
Entity|Entity|
Entries|Entries|
Entry|Entry|
Envelope|Envelope|
Environment|Environment|
e-prescribing|e-Prescribing|
e-Prescribing|e-Prescribing|
Equip|Equip|
Equivalency|Equivalency|
Equivalent|Equivalent|
ERROR|Error|
Error|Error|
Errors|Errors|
Evaluation|Evaluation|
Event|Event|
Examination|Examination|
Exceed|Exceed|
Except|Except|
Exception|Exception|
Exceptions|Exceptions|
Excess|Excess|
exclude|Exclude|
Exclude|Exclude|
Excluded|Excluded|
Exclusion|Exclusion|
Execution|Execution|
Exempt|Exempt|
Exist|Exist|
Existing|Existing|
Exists|Exists|
Exit|Exit|
Expected|Expected|
Expenditure|Expenditure|
Expensive|Expensive|
Expiration|Expiration|
Expire|Expire|
Expired|Expired|
Expiring|Expiring|
EXPLANATION|Explanation|
Explicit|Explicit|
Expression|Expression|
Extended|Extended|
Extension|Extension|
External|External|
Externally|Externally|
Extol|Extol|
Extract|Extract|
Facility|Facility|
Factor|Factor|
Failing|Failing|
Family|Family|
Fastener|Fastener|
Federal|Federal|
fee|Fee|
Fee|Fee|
Feed|Feed|
Fees|Fees|
Female|Female|
Females|Females|
FIELD|Field|
field|Field|
FIeld|Field|
Field|Field|
fields|Fields|
file?|File?|
File?|File?|
file|File|
FIle|File|
File|File|
Filename|Filename|
files|Files|
Files|Files|
Filing|Filing|
Fill|Fill|
Filled|Filled|
filler|Filler|
Filler|Filler|
Fills|Fills|
Fin|Fin|
Final|Final|
Financial|Financial|
Fines|Fines|
First|First|
Five|Five|
flag|Flag|
Flag|Flag|
Flat|Flat|
Floor|Floor|
Fold|Fold|
Follow|Follow|
font|Font|
Font|Font|
for|for|
For|for|
Form|Form|
format|Format|
Format|Format|
formats|Formats|
found|Found|
Four|Four|
Fraud|Fraud|
Free|Free|
Frequency|Frequency|
Friday|Friday|
FROM|From|
from|From|
From|From|
Front|Front|
Fulfillment|Fulfillment|
Full|Full|
Function|Function|
Functional|Functional|
Fund|Fund|
Funds|Funds|
Future|Future|
Gap|Gap|
Gateway|Gateway|
Gauge|Gauge|
Gender|Gender|
Generate|Generate|
Generic|Generic|
Global|Global|
Go|Go|
Grace|Grace|
Gross|Gross|
Group?|Group?|
GROUP|Group|
group|Group|
Group|Group|
Groups|Groups|
Guardian|Guardian|
HandiCap|Handicap|
Handicap|Handicap|
has|has|
Head|Head|
Header|Header|
heading|Heading|
Health|Health|
height|Height|
Height|Height|
Held|Held|
Help|Help|
Helpdesk|Helpdesk|
High|High|
Highest|Highest|
Hire|Hire|
Historical|Historical|
History|History|
Hold|Hold|
Holder|Holder|
Holiday|Holiday|
Home|Home|
Hospice|Hospice|
Hospital|Hospital|
Host|Host|
Hour|Hour|
Hours|Hours|
Household|Household|
Hypertension|Hypertension|
Hypothyroid|Hypothyroid|
Hypothyroidism|Hypothyroidism|
ID|Identifier|
ID?|Identifier?|
Identification|Identification|
IDENTIFIER|Identifier|
identifier|Identifier|
Identifier|Identifier|
if|If|
Ignore|Ignore|
Imbalance|Imbalance|
Impact|Impact|
In/Out|In/Out|
in|in|
In|in|
Inactivate|Inactivate|
Inactive|Inactive|
Incentive|Incentive|
INCIDENT|Incident|
Incident|Incident|
Include/Exclude|Include/Exclude|
Include|Include|
Inclusion|Inclusion|
Income|Income|
Increase|Increase|
Indent|Indent|
Index|Index|
Indicated|Indicated|
Indications|Indications|
indicator|Indicator|
Indicator|Indicator|
indicators|Indicators|
Individual|Individual|
Informational|Informational|
Ingredient|Ingredient|
Ingredients|Ingredients|
Initial|Initial|
Initials|Initials|
Initiated|Initiated|
Injury|Injury|
Ink|Ink|
Inner|Inner|
Input|Input|
Inquiry|Inquiry|
Insert|Insert|
Institutional|Institutional|
Instruct|Instruct|
Instruction|Instruction|
Instructions|Instructions|
Insurance|Insurance|
Insured|Insured|
Intend|Intend|
Intended|Intended|
Inter|Inter|
Interacting|Interacting|
Interaction|Interaction|
Interface|Interface|
Intermediary|Intermediary|
Internal/External|Internal/External|
Internal|Internal|
Interpretation|Interpretation|
Interval|Interval|
Intervention|Intervention|
Invalid|Invalid|
Inventory|Inventory|
Is|is|
Issue|Issue|
Issuer|Issuer|
Item|Item|
Items|Items|
Iteration|Iteration|
Iterations|Iterations|
Job|Job|
Jobs|Jobs|
Join|Join|
Julian|Julian|
key|Key|
Key|Key|
Keyboard|Keyboard|
Keys|Keys|
Knowledge|Knowledge|
Label|Label|
Labels|Labels|
Lag|Lag|
Lang|Lang|
Language|Language|
Larger|Larger|
Last|Last|
LATE|Late|
Latest|Latest|
Layer|Layer|
Legal|Legal|
Legend|Legend|
length|Length|
Length|Length|
Lens|Lens|
Letter|Letter|
Letters|Letters|
level|Level|
Level|Level|
library|Library|
LIbrary|Library|
Library|Library|
License|License|
Licensed|Licensed|
Life|Life|
Lifetime|Lifetime|
limit|Limit|
Limit|Limit|
Limited|Limited|
Limits|Limits|
Line|Line|
Link|Link|
Linked|Linked|
list|List|
List|List|
Listed|Listed|
Live|Live|
Load|Load|
Loaded|Loaded|
local|Local|
Local|Local|
Location|Location|
Lock|Lock|
logical|Logical|
Logical|Logical|
Login|Login|
Logo|Logo|
Long|Long|
Look|Look|
Lookup|Lookup|
Low|Low|
Lowest|Lowest|
Made|Made|
Mail|Mail|
Mailing|Mailing|
MAIN|Main|
Main|Main|
Maintain|Maintain|
Maintenance|Maintenance|
Major|Major|
Male|Male|
Males|Males|
Man|Man|
Management|Management|
Manual|Manual|
Manufacturer|Manufacturer|
Manufacturers|Manufacturers|
mapping|Mapping|
Mapping|Mapping|
Mark|Mark|
Market|Market|
Marketing|Marketing|
Mask|Mask|
Master|Master|
Match|Match|
Matched|Matched|
Matching|Matching|
Material|Material|
Matrix|Matrix|
Maximum|Maximum|
may|May|
Measure|Measure|
Measurement|Measurement|
Mechanism|Mechanism|
Media|Media|
Medicaid|Medicaid|
Medical|Medical|
Medicare|Medicare|
MediSpan|Medi-Span|
Medi-Span|Medi-Span|
Meg|Meg|
Megabytes|Megabytes|
Member/Family|Member/Family|
Member/Owner|Member/Owner|
MEMBER|Member|
member|Member|
Member|Member|
members|Members|
Members|Members|
Membership|Membership|
Memo|Memo|
Menu|Menu|
Merchant|Merchant|
Mess|Mess|
MESSAGE|Message|
Message|Message|
Messages|Messages|
Meta|Meta|
Method|Method|
Metric|Metric|
Micro|Micro|
Microorganism|Microorganism|
Mid|Mid|
Middle|Middle|
Military|Military|
Mill|Mill|
MILLISECOND|Millisecond|
Millisecond|Millisecond|
Mini|Mini|
Minimum|Minimum|
Minute|Minute|
Minutes|Minutes|
Miscellaneous|Miscellaneous|
Missed|Missed|
Mixed|Mixed|
Mode|Mode|
Model|Model|
Modification|Modification|
modified|Modified|
Modifier|Modifier|
Module|Module|
Monday|Monday|
Monitor|Monitor|
Month|Month|
Months|Months|
Multi|Multi|
Multiple|Multiple|
MultiSource|Multi-Source|
Multi-Source|Multi-Source|
Multi-source|Multi-Source|
MultiSrc|Multi-Source|
Multi-Src|Multi-Source|
must|Must|
Must|Must|
NAME|Name|
name|Name|
Name|Name|
Narrative|Narrative|
National|National|
Necessity|Necessity|
Need|Need|
Needle|Needle|
Negative|Negative|
Nested|Nested|
Net|Net|
Network|Network|
Networks|Networks|
New/Refil|New/Refill|
New/Refill|New/Refill|
New|New|
Next|Next|
Node|Node|
Non-Claim|Non-Claim|
none|None|
Non-Formulary|Non-Formulary|
Non-Qualified|Non-Qualified|
Non-Standard|Non-Standard|
Non-Std|Non-Standard|
not|Not|
Not|Not|
NOTE|Note|
Note|Note|
Notes|Notes|
Notice|Notice|
Notification|Notification|
Notified|Notified|
Notify|Notify|
Now|Now|
Null|Null|
Numb|Numb|
NUMBER|Number|
number|Number|
Number|Number|
Numeric|Numeric|
Object|Object|
Objective|Objective|
OBSOLETE|Obsolete|
Obsolete|Obsolete|
Obsoleted|Obsoleted|
Occur|Occur|
Occurrence|Occurrence|
Occurrences|Occurrences|
of|of|
Of|of|
Offending|Offending|
Office|Office|
Offset|Offset|
OH|Oh|
Old|Old|
on|On|
One|One|
Online|Online|
Only|Only|
Onset|Onset|
open|Open|
Open|Open|
Operations|Operations|
Operator|Operator|
Option|Option|
or|Or|
Orange|Orange|
Order|Order|
Ordinal|Ordinal|
Organization|Organization|
Origin|Origin|
Original|Original|
Origination|Origination|
Originator|Originator|
Other|Other|
Out|Out|
OutCome|Outcome|
Outcome|Outcome|
Outdated|Outdated|
Outer|Outer|
Output|Output|
Over|Over|
Overflow|Overflow|
overlap|Overlap|
Override?|Override?|
Override|Override|
Owner|Owner|
Pack|Pack|
Package|Package|
Packaging|Packaging|
Packing|Packing|
PAGE|Page|
page|Page|
Page|Page|
paid|Paid|
Paid|Paid|
Pair|Pair|
Panel|Panel|
Paper|Paper|
Parallel|Parallel|
Parameters|Parameters|
Parent|Parent|
Parenthesis|Parenthesis|
Part|Part|
Partial|Partial|
Participant|Participant|
Participate|Participate|
Party|Party|
Pass|Pass|
Passed|Passed|
PASSWORD|Password|
Password|Password|
Past|Past|
path|Path|
Path|Path|
PATIENT|Patient|
Patient|Patient|
Pattern|Pattern|
Payer|Payer|
Payment|Payment|
Payments|Payments|
Pediatrics|Pediatrics|
Pen|Pen|
Penalty|Penalty|
Pend|Pend|
Pended|Pended|
Pending|Pending|
per|per|
Per|per|
Percent|Percent|
Percentage|Percentage|
Period|Period|
Permanent|Permanent|
Permission|Permission|
Person|Person|
Pharmacist|Pharmacist|
Pharmacy|Pharmacy|
Phase|Phase|
Phone|Phone|
Physical|Physical|
Physician|Physician|
Pickup|Pickup|
Pin|Pin|
Place|Place|
Plan|Plan|
Plans|Plans|
Platform|Platform|
Plural|Plural|
Plus|Plus|
Pocket|Pocket|
Point|Point|
Policy|Policy|
pool|Pool|
Pop|Pop|
Populate|Populate|
Port|Port|
Portal|Portal|
Posit|Posit|
position|Position|
Position|Position|
positions|Positions|
Positive/Negative|Positive/Negative|
Positive|Positive|
Possible|Possible|
Post|Post|
Posted|Posted|
Posting|Posting|
Potential|Potential|
Pre-Adjudication|Pre-Adjudication|
Precaution|Precaution|
Preceded|Preceded|
Preferred|Preferred|
Prefix|Prefix|
Pregnancy|Pregnancy|
Pregnant|Pregnant|
Premium|Premium|
Prescribed|Prescribed|
Prescription|Prescription|
Prescriptions|Prescriptions|
Preview|Preview|
PREVIOUS|Previous|
Previous|Previous|
Price?|Price?|
price|Price|
Price|Price|
pricing|Pricing|
Pricing|Pricing|
Prim|Prim|
Primary|Primary|
Print|Print|
Prior|Prior|
Priority|Priority|
Private|Private|
Pro|Pro|
Process|Process|
Processed|Processed|
Processing|Processing|
PROCESSOR|Processor|
Processor|Processor|
Prod|Prod|
Product|Product|
Products|Products|
Professional|Professional|
Profile|Profile|
Program|Program|
Project|Project|
prompt|Prompt|
Prompt|Prompt|
Prompts|Prompts|
Proprietary|Proprietary|
Prorated|Prorated|
Protocol|Protocol|
Provider|Provider|
Proxy|Proxy|
Publisher|Publisher|
Pull|Pull|
Purge|Purge|
Purged|Purged|
Qualifier|Qualifier|
Quantity|Quantity|
Quarter|Quarter|
Question|Question|
Queue|Queue|
RACER|Racer|
RAFT|Raft|
Range|Range|
Rank|Rank|
Rate|Rate|
RATER|Rater|
Rating|Rating|
Ratio|Ratio|
Reaction|Reaction|
Reactivate|Reactivate|
Reason|Reason|
Reassign|Reassign|
Rebate|Rebate|
Receive|Receive|
Received|Received|
Receiver|Receiver|
Receiving|Receiving|
Receptor|Receptor|
Recipient|Recipient|
Reclaimed|Reclaimed|
Recognize|Recognize|
Reconciled|Reconciled|
Reconciliation|Reconciliation|
Reconcilied|Reconciled|
record|Record|
Record|Record|
Records|Records|
Redirect|Redirect|
Reduced|Reduced|
Reduction|Reduction|
Reels|Reels|
Refer|Refer|
reference|Reference|
Reference|Reference|
Referral|Referral|
refill|Refill|
Refill|Refill|
Refills|Refills|
Reformat|Reformat|
Refresh|Refresh|
Refusal|Refusal|
Regenerate|Regenerate|
Region|Region|
Regional|Regional|
Registration|Registration|
Reimburse|Reimburse|
REIMBURSEMENT|Reimbursement|
Reimbursement|Reimbursement|
Reject|Reject|
Rejected|Rejected|
Rejection|Rejection|
Rejects|Rejects|
Related|Related|
Relation|Relation|
Relationhsip|Relationship|
Relationship|Relationship|
Relative|Relative|
Release|Release|
Released|Released|
Remain|Remain|
Remaining|Remaining|
Remit|Remit|
Remittance|Remittance|
Remote/Local|Remote/Local|
remote|Remote|
Remote|Remote|
Removal|Removal|
Renew|Renew|
Renewal|Renewal|
Reopen|Reopen|
Reopened|Reopened|
Repackage|Repackage|
Repackaged|Repackaged|
Repackager|Repackager|
Repackaging|Repackaging|
Repair|Repair|
Repeated|Repeated|
Replace|Replace|
Replacement|Replacement|
Reply|Reply|
Report|Report|
Reported|Reported|
Reporting|Reporting|
Reprint|Reprint|
Reprocess|Reprocess|
Reprocessed|Reprocessed|
Reprocessing|Reprocessing|
Request|Request|
Requested|Requested|
Requesting|Requesting|
Requests|Requests|
Require|Require|
required|Required|
Required|Required|
Requirement|Requirement|
Rerun|Rerun|
Reserve|Reserve|
Reserved|Reserved|
Reset|Reset|
Residence/Service|Residence/Service|
Residence|Residence|
Resolved|Resolved|
Response|Response|
Responsible|Responsible|
Rest|Rest|
RESTORE|Restore|
Restore|Restore|
Restrict|Restrict|
Restriction|Restriction|
Restrictions|Restrictions|
RestS|Rests|
Resubmission|Resubmission|
Resubmit|Resubmit|
Result|Result|
Retail|Retail|
Retain|Retain|
Retained|Retained|
Retention|Retention|
Retire|Retire|
Retirement|Retirement|
Retransmit|Retransmit|
Retrieval|Retrieval|
Return|Return|
Returned|Returned|
Reversal|Reversal|
Reversed|Reversed|
Review|Review|
Rider|Rider|
Rights|Rights|
Risk|Risk|
Role|Role|
Root|Root|
Route|Route|
Router|Router|
Routing|Routing|
Row|Row|
Rule|Rule|
Rules|Rules|
Run|Run|
Runoff|Runoff|
Rural|Rural|
Sale|Sale|
Sales|Sales|
Salutation|Salutation|
Same|Same|
Sanction|Sanction|
Saturday|Saturday|
Save|Save|
SAVED|Saved|
Saved|Saved|
Saving|Saving|
Savings|Savings|
Scan|Scan|
Schedule|Schedule|
Scheduled|Scheduled|
Score|Score|
SCRIPT|Script|
Search|Search|
Second|Second|
Secondary|Secondary|
Secret|Secret|
Sector|Sector|
Security|Security|
Segment|Segment|
Select|Select|
Selected|Selected|
Selection|Selection|
Send|Send|
Sender|Sender|
Sending|Sending|
Sensitivity|Sensitivity|
Sent|Sent|
separator|Separator|
Separator|Separator|
SEQUENCE|Sequence|
Sequence|Sequence|
Serial|Serial|
Server|Server|
Service?|Service?|
SERVICE|Service|
Service|Service|
Services|Services|
Session|Session|
set|Set|
Set|Set|
Severity|Severity|
Sex|Sex|
Share|Share|
Shelf|Shelf|
shift|Shift|
Shipper|Shipper|
Short|Short|
Side|Side|
sign|Sign|
Sign|Sign|
Signature|Signature|
Significance|Significance|
Simplex|Simplex|
Single|Single|
Singular|Singular|
SIRE|Sire|
Site|Site|
size|Size|
Size|Size|
Skip|Skip|
slow|Slow|
Smaller|Smaller|
Smoke|Smoke|
Smoker|Smoker|
Smoking|Smoking|
Social|Social|
Soft|Soft|
Software|Software|
Sort|Sort|
Source|Source|
Spacer|Spacer|
Spec|Spec|
Special|Special|
Specialty|Specialty|
Spend|Spend|
SPIN|Spin|
Split|Split|
Sponsor|Sponsor|
Spool|Spool|
Spouse|Spouse|
Spread|Spread|
Stability|Stability|
Stage|Stage|
Staged|Staged|
Stamp|Stamp|
Stand|Stand|
Standard|Standard|
Standing|Standing|
Start|Start|
Started|Started|
starting|Starting|
Starting|Starting|
Startup|Startup|
State|State|
Statistics|Statistics|
status|Status|
Status|Status|
Statute|Statute|
Step|Step|
Steps|Steps|
Stock|Stock|
storage|Storage|
Storage|Storage|
Store|Store|
Stored|Stored|
Street|Street|
strength|Strength|
Strength|Strength|
Structure|Structure|
Stub|Stub|
Stud|Stud|
Student|Student|
Subject|Subject|
Submission|Submission|
Submit|Submit|
SUBMITTED|Submitted|
Submitted|Submitted|
Submitting|Submitting|
Subs|Subs|
SUBSCRIBER|Subscriber|
Subscriber|Subscriber|
Subset|Subset|
Subsidy|Subsidy|
Substance|Substance|
Substitution|Substitution|
Substring|Substring|
Subsystem|Subsystem|
Succeed|Succeed|
Success|Success|
Suffix|Suffix|
Suite|Suite|
Summary|Summary|
Sunday|Sunday|
Super|Super|
Supplement|Supplement|
Supplemental|Supplemental|
Supplies|Supplies|
Supply|Supply|
Support|Support|
Supporting|Supporting|
Suppress|Suppress|
Suppression|Suppression|
Surrogate|Surrogate|
Suspend|Suspend|
Sweep|Sweep|
Switch|Switch|
Syringe|Syringe|
System?|System?|
System|System|
Systemic|Systemic|
Tab|Tab|
table|Table|
Table|Table|
Taken|Taken|
Tape|Tape|
Target|Target|
TASK|Task|
Task|Task|
tax|Tax|
Tax|Tax|
Taxonomy|Taxonomy|
Telephone|Telephone|
Template|Template|
Term|Term|
Termed|Termed|
Terminal|Terminal|
Terminate|Terminate|
Termination|Termination|
Terms|Terms|
Test|Test|
TEXT|Text|
text|Text|
Text|Text|
the|The|
Therapeutic|Therapeutic|
Theraputic|Therapeutic|
Therapy|Therapy|
Therpeutic|Therapeutic|
Third|Third|
This|This|
Three|Three|
Threshold|Threshold|
Through|Through|
Thursday|Thursday|
Tier|Tier|
TIME|Time|
time|Time|
Time|Time|
Times|Times|
TimeStamp|Timestamp|
Timestamp|Timestamp|
Title|Title|
to|to|
To|to|
Tolerance|Tolerance|
Top|Top|
TOTAL|Total|
Total|Total|
Trace|Trace|
Tracking|Tracking|
Trademark|Trademark|
Trailer|Trailer|
transact|Transact|
Transact|Transact|
transaction|Transaction|
Transaction|Transaction|
TransactionIdentifier|Transaction Identifier|
Transactions|Transactions|
Transfer|Transfer|
Transferred|Transferred|
Transform|Transform|
Transition|Transition|
Transitional|Transitional|
Translation|Translation|
Transmission|Transmission|
Transmitted|Transmitted|
Treatment|Treatment|
Trial|Trial|
Trigger?|Trigger?|
Trigger|Trigger|
Truncated|Truncated|
Tuesday|Tuesday|
Two|Two|
type|Type|
Type|Type|
Types|Types|
Unavailable|Unavailable|
Uncovered|Uncovered|
Unique|Unique|
Unit|Unit|
Units|Units|
Universal|Universal|
Unknown|Unknown|
Unused|Unused|
up|Up|
Up|Up|
update|Update|
Update|Update|
Updated|Updated|
Us|Us|
Usage|Usage|
Use|Use|
Used|Used|
USER|User|
User|User|
Usual|Usual|
Utilization|Utilization|
Utilizing|Utilizing|
Valid|Valid|
Validate|Validate|
Validated|Validated|
validation|Validation|
Validation|Validation|
validity|Validity|
Value:|Value:|
value:|Value:|
value|Value|
Value|Value|
Variable|Variable|
Variance|Variance|
Vendor|Vendor|
Verbal|Verbal|
Verification|Verification|
Verify|Verify|
Version|Version|
View|View|
Void|Void|
Volume|Volume|
Voucher|Voucher|
w/|with|
wait|Wait|
Wait|Wait|
Waived|Waived|
Warning|Warning|
Web|Web|
Website|Website|
Wednesday|Wednesday|
Week|Week|
Weekend|Weekend|
Weight|Weight|
Welfare|Welfare|
Whole|Whole|
Wholesale|Wholesale|
Wholesaler|Wholesaler|
width|Width|
Wild|Wild|
Wildcard|Wildcard|
Win|Win|
Window?|Window?|
Window|Window|
Windows|Windows|
with|With|
Withhold|Withhold|
within|Within|
Wldcard|Wildcard|
Word|Word|
Work|Work|
Worker|Worker|
Workers|Workers|
Working|Working|
Would|Would|
Wrapped|Wrapped|
Wrapper|Wrapper|
Write|Write|
Written|Written|
Year|Year|
Yearly|Yearly|
Years|Years|
Yes|Yes|
Zero|Zero|
Zone|Zone|
Zoned|Zoned|
